ব্যাকরণবিধি	Byakoronbidhi
স্টান্সে	stance a
শ্রীজিত	Srijit
ধন্যবান	dhonnoban
অলিপাব	olypub
লেগবাই	legbai
থোরাক্স	thorax
ওয়েবসাইটের	Website er
তনুজা	Tanuja
লিটেরারি	literary
শক্তির	Soktir
ভদ্রেশ্বরের	Bhadreswarer
শমীককেই	Shomikkei
৩২জিবির	32GBr
বিশ্বজয়ের	Bishyojoyer
সম্প্রসারণের	somprosaroner
শয্যাসঙ্গিনী	sojyasangini
নববর্ষের	noboborsher
সার্বিয়ায়	serbiaay
সিসিআই	CCI
তাঁকে৷	tnaake
সুইসোতেল	suisotel
জোশের	Josher
দলগুলি	Dolguli
টানার	Tanar
গার্ডেনরিচের	gardenricher
কমলালেবু	Komolalebu
আরবাজ	Aarbaaj
KD	KD
সংক্রমণও	sankraman
ঘেঁসে	ghnese
কমান্ডহীন	commandhin
বয়ানেও	Boyaneo
পিকেটিংও	picketingo
আনবাড়ি	Anbari
বিশ্বক্লাব	Bishwa Club
নৈরাজ্যের	noirajjer
ইনকা	inca
বাড়াটে	Barate
সেইটিই	sheiti-e
শরীরচর্চার	sorirchorchar
মালাই	cream
হাবেও	Hubeo
অফিসারকে	Officerke
বছরছয়েক	bocchorchhoyek
আড়াইশোতম	Araishotomo
মাহির	mahir
স্পষ্টভাষায়	Sposhtobhashay
বিধির	Bidhir
সাবরমতীর	Sabarmatir
অবিলম্বেই	obilombei
কোন্তা	konta
অলিম্পিকেও	Olimpikeo
মতবাদকে	Modbadak
পরদল	porodol
পরদল	pordol
ফলায়	Shohaay
চুমুকে	Chumuke
পর্বতারোহণও	porbotarohono
নীলাংশি	nilangshi
ছবিটাকে	Chobitake
সনাতনই	sonatonee
আলাদা	alada
আলাদা	alada
গ্রাফটা	Graphta
প্রতিবাদটি	protibadti
লোডশেডিং	loadshedding
শিল্পবিরোধী	Shilpobirodhi
রেড্ডিকে	Reddyke
বৃষ্টির	brishtir
গুরুজনদের	gurujonder
তলদেশে	Tolodesh
পুনরুদ্ধারের	punorudharer
কম্পিটিটিভ	Competitive
বাইকগুলির	Bikegulir
অবতারণা	obotarona
ব্যাপক	Byapok
ওয়াটারের	waterer
নামঘরে	Namghore
নামঘরে	Namghore
মেয়াদকে	meyadke
কোলে	Kole
পেন্টিং	penting
পেনকা	penka
লোকসভার	loksabhar
ক্রসভোটিং	crossvoting
ইমপ্রুভমেন্ট	Improvement
চলত	Cholto
শ্রীবই	Shreeboi
লড়াই—	lorai
যানজটও	zanjoT
প্রতিবারের	protibarer
প্রতিবারের	Protibarer
অর্ণবের	arnober
আখতার	akhtar
২৬০০	2600
পুড়িয়েছিলেন	Puriyechilen
টাঁকশাল	tyakshal
সেতুগুলির	Setugulor
শব্দবন্ধে	sobdobondhe
গিয়ারকে	giyarke
জতুগৃহে	jatugrihe
মঞ্চস্থ	moncho
আত্মদানের	attodaner
সমধানের	somadhaner
স্টুডেন্টকে	student-ke
চন্দনাকে	Chandanake
২৩তম	23tomo
টি‌ভিতে	TVte
ট্যাবলয়েডে	tabloide
মোটরগাড়ির	motorgarir
মনঃপুত	Monohputo
নুপূর	Nupur
ওয়াপসি	wapsi
রাঁচিতেও	ranchiteo
অভিমন্যুকে	Ovimonnyuke
গির্জাতেই	Girjatei
সেইসূত্রে	Sheishutre
ট্রাস্টির	Trusteer
হেডকোয়ার্টারে	Headquarterer
পিতামহ	Pitamoho
ছিটিয়েই	chitiyei
লঙ্কাজয়ে	Lankajoye
ইরফান	irfan
স্পেশ্যালি	specially
গড়ুক	goruk
অফসেটের	offset er
তনুত্যাগের	Tonutyager
এবাড়িতে	ebarite
আইটি	IT
তুড়তুড়ি	turturi
অ্যাপোলো	Apollo
সর্দি	Cold
কাটালেও	Kataleo
কুড়িয়েছিল	Scavenged
দিনগুলিতেই	dingulitei
৭০০০	7000
১৯৮টি	198ti
ছাত্রীকেও	chhatrikeo
শরাফের	shorafer
মানবসমাজে	manobsomaje
আটকালে	atkale
চালকল	chalkol
ডাকনামা	Daknama
ডাকনামা	Daknama
৬৯৮	698
প্রশাসনকেই	Proshashonkei
১৭৪টি	174ti
লোকবহন	lokbohon
ক্যাচ	Catch
শেষচেষ্টা	seshchesta
ময়ূখ	moyukh
মোডিফায়েড	modified
মোডিফায়েড	modified
রঘুনন্দন	Roghunondon
যুগেও	Jugeo
অ্যাসিস্ট্যান্ত	Assistant
ধরণী	Dharani
শীর্ষনেতারাও	shirshonetaraw
বিপণীবিতান	biponibitan
পুনর্গঠন	punorgothon
ক্ষেপণাস্ত্রটিকে	Skheponastrotike
কনসেন্ট	Concent
দ্রাবিড়দের	Dravirder
পতন৷	Poton
পাড়ুয়েই	Paruyei
হৃদ	Hrid
সিন্হাকে	sinhake
হারাননি	Haran ni
ব্লাটারদের	blatarder
সংহতিদিবসের	Songhotidiboser
ফাগুনেই	Phagunei
স্বাদগন্ধে	swadgondhe
মণিমুকুট	monimukut
পুলিশের৷	Policer
পুলিশের৷	Policer
চাকচিক্যে	chakchikye
দস্তগীর	dastagir
শোনা	Shona
দলটি	dolti
উপড়ে	Upre
উপলক্ষ্যেই	upolokhyei
কারখানাটিই	Karkhanatiy
কবিরাও	kobirao
সাপ	Saap
জতুগৃহেই	jodugrihei
ভাওয়াল	bhawal
মিসপাসে	Misspass a
আটর	Ator
ডায়েরিতেও	Dairyteo
নূরকে	nurke
লোলা	lola
শব্দবন্ধ	Shobdobondho
২০২২	2022
ভিসার	visar
কোচেরাই	kocherai
ছেলে	chele
বিশপকে	Bishopke
নোনতা	Nonta
ধাপই	Dhapai
বিদ্যুত্	bidyut
বদ্রিনাথ	bodrinath
মানুষটি	Manush ti
ওবামাকেও	obamakeo
শিবিরগুলিতে	Shibirgulite
গোবিন্দা	Govinda
জিতবই	Jitboi
ভিডিওগুলো	Videogulo
অভিযাগকারীই	obhijogkarie
নাভি	nabhi
মারামারিই	Maramari e
ভয়ংকর	Bhoyankar
৩১২টি	holiday
চাপুক—	chapuk
ন্যাশনালের	nationaler
পুষ্পলতাকে	Pushpolotake
সুখানুভূতির	sukhanuvutir
প্রাক্‌	Nomoskarante
হোসেলিনের	hoseliner
ছাত্রসংসদ	Apreetikor
খণ্ডাংশ	khondasho
শুভ্রাংশুও	shubhrangshu
পড়ত	Porto
ফাঁদেই	Fandei
রইরই	Roiroi
আওয়ারে	Aware
ডিআরআই	DRI
জলকেলি	Jolokeli
সহযোগী	Shohojogi
কারাটাই	karatai
বাসনপত্রও	Basonpotrou
তোবগের	tobger
ব্যবহারকারিদের	byaboharkarider
জেল্লার	jellar
৩২৯	329
মানুষগুলোর	manushgulor
পড়াশোনারও	porashonaro
বাসুদেব	Basudeb
ফুরসৎ	fursot
অখ্যাত	okhyat
হরিয়ানাকে	horiyanake
ছবিটাতে	Chhobitate
উল্লেখ	Ullekh
প্রোজেক্ট	project
আঁকতে	Aankte
ডাকতেই	daktei
অতিরিক্তি	otirikti
হাতিয়ারেই	hatiarei
সোভিয়েতের	Sovieter
রুহিকে	Ruhike
সেল্টা	selta
অস্ত্রগুলো	ostrogulo
বিচ্ছিন্নভাবে	bichcinnovabe
আলুভাজা	alubhaja
পাঠ্যক্রম	patthokrom
আশিফ৷	Aashif
নূতনের	Nutoner
সন্দেহে	sondehe
শুভ্রাংশুকে	shuvranngsuke
ভালবাসি”	valobasi
বক্তারা	boktara
নেভেহ্‌	neveh
সংখ্যাও	sokhyao
অচিত্যার	ochityar
ওবাই	Obai
অপদস্থ	Opodostho
সিএস	CS
কসমেটিক্স	kosmetics
লোকনাথেরও	Loknathero
ডিসিশনকে	Decision ke
দেশটাই	deshtai
বিদ্রূপ	satire
ইন্টারভ্যালের	Intervaler
অনুশীলনরত	onushilonroto
অনুশীলনরত	onushilonroto
বখরিয়ারপুরে	Bokhriarpure
বাতিলরে	Batilre
রথগুলি	rothguli
নিপুলবাবু	nipulbabu
ক্রশিং	Crossing
নিরাপত্তকর্মীকে	nirapottakormik
কুড়নোর	kurnor
নীলাংশু	Neelangshu
ম্যাগনাকার্টা	Magnakarta
রোম্যান্স	romance
রোম্যান্স	romance
১৩বি	13B
মধ্যাহ্নভোজ	Modhyanobhoj
দীপিকা—	deepika-
সেনসিবল	Sensible
সেনসিবল	sensible
সুইডেনে	Swedene
খঁজতে	khojte
ব্যতিব্যস্ত	Byatibyasto
রয়েছে…”	royechey
সিভিতে	CV te
খামে	Khame
নেশাকেই	Neshakei
আঠা	atha
অন্ধপ্রদেশ	andhrapradesh
উদ্বাস্তুদের	uddhastoder
কুক্ষিগত	hello
ওয়াক	Oaak
মানডে	mande
অমানবিকতার	omanobikotar
পেপারলেস	Psperless
আকর্ষণের	Akorshoner
জানিয়েদিলেন	janiyedilen
প্রত্যাহারে	protyahar
রুখে	Rukhe
মিষ্টে	Mishte
রাহুলবাবা	rahulbaba
উগ্রতা	Harshness
উৎসাহে	utshahe
পাবো	pabo
লম্পট	lompat
অভ্যেস	obbhesh
বাংলাদেশির	Bangladeshir
ম্যালেনা	Malena
পড়ে	pore
কয়জনা	koyejona
করিমুল	korimul
পাওয়াতেই	Pawatei
দেশদ্রোহের	Deshodroher
বান্ধবদের	Bandhobder
লানা	lana
পুনঃপ্রমাণ	Punoh-promaan
চোলাইএর	cholaier
বেধড়ক	bedhoRok
কুক্কড়	kukkor
নিযেছে	niyechhe
ইয়ারএর	yaarer
ক্রীড়া	krira
হেলাফেলা	ignore
পাল্‌কি	Palki
মুলতে	mulote
ক্রিকেটগুরু	Cricketguru
ক্রীড়াবিদকে	Krirabidke
ক্রিকেটে	crickete
দীনতার	Dinotaar
বিষয়টিকে	bishoytike
ব্যাধের	byadher
গ্রসিং	Grossing
ভক্কম	Bhokkom
শাসনকে	shashonke
বুড়ো	buro
পাত্তর	Pattor
বিশ্বটাই	Doordanto
ভৌতিক	bhoutik
কাঁদুনে	kadune
ভোটধারানিবদ্ধ	Votdharaniboddho
জয়রামবাটিতেই	Kobita
জানিয়ে‌ছি”—	janiyechhi-
ক্যাবিনেটসচিবকে	sdasd
ফিলমসের	Filomoser
হত্যাকারী	Killer
হত্যাকারী	hotyakari
মাততেন	matten
KMDA	KMDA
সাহায্যে	sahajyes
লাস্যে	lassye
ধুপকাঠির	dhupkathir
শোধনাগারে	Shodhanagare
তিরানব্বই	Ninety three
মস্ত	mosto
ফ্যাক্ট	fact
শিকদার	Shikdar
মামলাকারীদের	mamlakarider
সিংভূম	Singhbhumo
মাকড়সাটির	makorshatir
জুড়োল	jurolo
প্লাতিনি	Platini
ইন্দ্রধনুশ	Indradhanush
কর্মশালা	kormoshala
ভারিলা	Bharila
বাজপেয়ীজিকে	Bajpeyiji ke
সুহানে	suhane
২৪৬	duishotochechollish
ক্লার্ক	Clerk
রিসর্টে	resorte
পরিছন্নতার	porichhonotar
১৮৭৫	1875
ফলই	Foloi
ঘটি	ghoti
মহারাজগঞ্জ	maharajganj
জন্যকে	Jonyoke
অভিজ্ঞ়	Obhiggo
বোহেমিয়ান	Bohemian
গার্নার	garrnar
নকশাল	Nakshal
বৃন্দাবনেই	brindabon ei
সাক্ষাত্কারকে	Sakkhatkarke
পূর্ণমান	Full scale
দাম্পত্যকলহ	dampotyokoloho
অনিশাকে	Anisha ke
পেয়েছিলাম	peyechilam
দুর্বিনীত	Durbinito
খোঁপায়	Khopay
পগার	Salary
ট্রায়ালে	traile
পাঁজি	Panji
দামানি	Damani
জেনতে	jenote
আমান্ডা	amanda
টাকাতো	Takato
বন্দিদের	Bondider
শাওয়ারে	showereys
গণশার	Gonshar
পুলকেশ	Pulokesh
বিমুদ্রা	bimudra
সজ্জন	gentleman
মিছিলেই	Michilei
দুইকে	Duike
কখনোই	Kokhonoi
মোটা	Fat
খনা	Khona
কোথা	KOTHA
করছাড়	korchar
কোনওটাতে	Konotate
সিদ্ধপীঠ	Sidhhopeeth
মহাদিক	Mohadik
ছিঁড়েছে	Chnireche
আর্য	Arya
ইস্তেহারে	istehare
সমুদ্রসৈকত	somudrosoikot
সুচ	suc
ছমিনিটে	Chho minite
মুশকিলে	Mushkile
ডিওয়াইএফআই	DYFI
দরজাতে	dorjate
বত্রিশের	Botrisher
প্রামাণিক	pramanik
শোকপ্রকাশকেও	even in mourning
পোয়া	poya
লুকের	looker
আঁচটুকু	Anchtuku
হাবের	haber
ঢাকঢোল	Dhakdhol
শক্তিরঙ্গ	shoktirongo
৫৩১টি	531 ti
তুরস্কও	turosko o
বাধই	badhoi
সন্ধানীদের	Sondhanider
ডায়ানাও	Dianao
বাথটব	bathtub
ফেয়ারনেস	Fairness
বায়োটিক	Biotica
অন্যছকের	Anyachokher
দীর্ঘদেহীই	Dirghodehi
রাজীবকুমারের	rajibkumarer
বিধু	Bidhu
পাটোয়ারি	patoari
এলোমেলো	Elomelo
মার্জিনও	Margineo
দস্তুরমতো	Dosturmoto
প্লেয়ারদের	Playerder
বিষয়টিতেও	Subject
ব্যাটিংয়ের	battinger
গিলিস	gilish
রায়৷	Judgement
হাপিশ	Haapish
পরণে	Porone
সেপসিস	Sepsis
বিশারদরা	bisharodora
কম্বলে	kombole
মির্জার	Mirzar
স্বজনকে	Swajonke
ডুয়ার্টের	Duarter
হেল্পফুল	helpful
সেলুন	Saloon
পুণেরি	puneri
টনিরা	tonira
বোঝেনা	Bojhena
৪৭২	472
ছুড়ুন	Chhurun
ক্যাটেগরিতেই	Catagorytei
দুটকরো	Du-tukro
দুর্দান্তভাবেই	Durdantobhabei
যুবরাজের	Yuvarajer
কাঠামোয়	in structure
মধুরেন	Modhuren
দুপক্ষের	Dupokhher
আন্দোলনরত	andolonroto
শাস্ত্র	shastr
ফেস্টিভ্যালএর	festivaler
সত্ত্বেওপালিত	Sottweopalito
শর্টসের	shorts er
কর্মচারীরা	Workers
কুসুম্বা	Kusumba
উৎপন্ন	utpanno
৩১৭	317
বিদেশিনিই	bideshini e
স্থানীয়দেরও	sthanioder o
উদাসীনতা	Udaseenota
কাউন্সিলরদের	councilorder
নীরাংশু	Neerangshu
রয়েছে	Royeche
বয়ঃজ‍্যেষ্ঠ	Boyojoyshtho
সৌমজিত্	shoumojit
খাতুনও	khatun o
চাকরিপ্রার্থীরাই	chakriprathirai
অংশ—	ongsho
নামালে	namale
সমস্যাগ্রস্ত	Somosyagrosto
ঘরবাড়ি	Building
ছবি	ami
শাইমান	Shaiman
নীতিশ	Nitish
অ্যাফেক্টেড	Affected
স্কোরবোর্ডের	scoreboarder
মর্যাদাপূর্ণ	morjadapurno
কোয়ান্টিকোতে	quantico te
THIS	THIS
পকেটের	Pocketer
অগাস্ট	August
এরাজ্যেও	Erajyeo
অডিওটির	Audiotir
বিশ্বরূপ	Biswarup
শ্রীজাতদা	srijatoda
মতে	Mote
বংশ	bongsho
অপলাপ	Opolap
জেড্ডার	jeddar
ঝুপড়িও	jhuprio
বাছাড়পাড়ায়	bchharparay
থেকো	Theko
সর্বস্তরজুড়ে	sorbostorjure
অগ্নিভ	agnibha
বধিরকে	bodhir k
৭২	Seventy two
মানকড়	mankod
কানেকশনে	connectione
মাথাচাড়া	mathachara
১৮৪৩	1843
অসম্পূর্ণতা	osompurnota
মানবোত্তর	Manbottor
গড়কড়ি	Gorkori
ফতহ্‌	fateg
যাদবপুরেই	Jadavpurei
তারুণ্য	Tarunnyo
নেওটিয়ারাও	Neotiara
রতুয়া	Rtuya
ঘেরার	gherar
খাদ্যপ্রেমীদের	Khadyopremider
প্রবাদের	probader
ভয়ের	Fearsome
অবাঙালি	obangali
চতুর্থদিনে	choturthodine
কবিতচর্চা	kobitachorcha
তেরই	taroi
সরানোর	soranor
গাঙে	gange
ঝোলেই	jholai
শায়কে	Shayke
গোমসের	gomser
হাফিফুল	Hafiful
গোলাবাড়ি	golabari
মোহনিয়াকে	mohniyake
বিদ্যালয়ে	bidyaloye
নিকোলকে	Nichole ke
বইপত্তরই	boipottor
মাখে	makhe
প্রমীলারা	promilara
জগত	jogot
সহারনপুর	Saharanpur
খাওয়াচ্ছে	khawacche
কিংবদন্তি	Kingbodonti
যশরাজ	Yashraj
চিত্রবাণী	chitrobani
দাঁড়কাগ	darkak
আন্দোলনের	Andoloner
অ্যাটলাস	atlas
বছরটাও	Bocchortao
গৃহধূদের	grihodhuder
আলিশায়	alishay
মাল্টিটাস্কার	multitasker
লালিয়া	Laliya
ঘাঁটিতে	Ghatite
বেরুলেন	Berulen
কমিশনে	KorOna
ঘূর্ণির	Ghurnir
ইচ্ছাপূরণের	Ichchhapuroner
সিজন	season
যুদ্ধ	Juddho
১১৬বি	116b
২টোতেও	dutoteo
প্রস্তর	Prostor
মুকুন্দপুরসহ	mukundopursoho
ভাবের	bhaber
সঙ্গীতশিল্পীদের	sangitshilpider
সোমাবারও	sombar o
পেটুক	Cormorant
ক্লায়েন্টরা	Clientra
ভ্যালিও	Vyalio
ব্যাঙের	Byanger
হিথের	hither
জবির	jobirs
কৃত্তিবাসের	Krittibasers
সঞ্জীবকে	Sonjibke
ভেঙ্গে	bhenges
ভেঙ্গে	venge
বাঁশদ্রোনী	bashdroni
কর্ণজিত	kornojit
অনুপ্রাণিত	onuprnito
এন্টালি	entally
বিশ্বক্রীড়ায়	bishwakriray
শাহজাহানকেও	sahjahankeo
কিডস	kids
নিরাপত্তাও	Nirapottao
নি্জস্ব	Nijossho
অনন্তপক্ষে	onontopokhhe
এগপ্লান্ট	eggplant
মাঠই	mathi
ডেভিডসনের	Devidson er
অ্যাঙ্করের	anchorer
পুকুরটিতে	In the pond
কসাইখানাগুলি	kosaikhanaguli
বরফঠান্ডা	borofthanda
উড়ানটিও	urantio
অরাজনৈতিক	orajnoitik
ক্লাচ	Clutch
রেন	ren
৫৩১৯৮	52198
ঘোষণা—তিনি	Ghosona-tini
সুরঞ্জন	Suranjan
ইউডিউব	Utube
পৌঁছলেন	Pouchholen
বনপলাশীর	Bonpolashir
ট্রাম্পকেই	Trump
বঙ্গোপসাগেরর	Bongoposagarer
সঞ্জয়কেও	Sanjay too
পাঁচতলার	panchtolar
মোদীই	modi
গলি	Goli
অতিপ্রাকৃতরাই	Otiprakritorai
নির্ঝঞ্ঝাট	Nirjhonjat
ধর্ম্ম	Dhormo
গজকে	Elephant
রবীন্দ্রসঙ্গীতে	Rabindrasangeet
কিরিয়া	Kiriya
ওঁদেরকে	oderkeo
চাদর	chador
চিকিত্‍করা	chikitora
আইনসম্মত	ainsommotos
প্যাড	pad
নির্যস	Nirjosh
সিক্রেটই	secret
রায়রা	rayra
মাঞ্জাও	manjao
পরদেশ	Pardesh
ইনোনো	Inono
চিন্ময়ী	chinmoyee
আধুলি	Adhuli
ড্যাশক্যামটি	Dashcamti
সরলেই	sorlei
জার্নাল	Journal
বুকিদের	bookieder
যমরাজের	Yamrajer
কতরকমেরই	Kotorokomerye
ট্রাইব্যুনালের	Tribunaler
রঞ্জনবাবু৷	ranjanbabu
থেতলে	mundu
মেনেনদেজ	menendey's
বলাবাহুল্য	bolabahullo
ছেলেপিলেরাই	chelepilerai
অঙ্গদাতা	ongodata
রওনা	royna
গডে়	Gore
চাঁদনি	Moonlight
হাসলেন	Hashlen
বিচারপ্রক্রিয়ার	Bicharprokriyar
ধারণাটিই	dharonati
হুজি	huji
তিনদিনের	Tindiner
সঙ্গাকারা	Sangakara
মানবিক	Manobik
চ্যানেল	Channel
নির্ভরতার	Nirbhorotar
তহবিলও	tohobilo
মোহিত	mohit
কক্কর	kokkor
খরগোনকর	khorgonkor
খেলছেন	khelchen
কালারস	Kalarosh
মাপেননি	Mapenni
শিকারিরা	shikarira
হেমারেজে	hamarez
চাকি	chaki
সিঁড়িতেই	sniritei
ব্রজমোহন	Brojomohon
বাসেন	Basen
সুমনের	Sumaner
নন্দরাম	nondoram
রতনদের	Ratander
বিটকয়েনকে	Bitkoyenke
মাখানো	makhano
মোদীদের	modider
রিচার্ডসের	Richards er
মেটাচ্ছেন	Metachchhen
গাঁজার	Ganjar
স্লিভগুলো	Slivgulo
বেন্টিং	benting
দশা	Dawsha
কিম্ভুতকে	kimbhutke
ভূমিহীন	vumihin
পরিকল্পনামাফিক	porikolponamafik
নিয়েই	niyei
সাপুরজি	Sapurji
হারেরও	harero
পেরিয়েছিল	Periyechhilo
এগুলির	Egulir
নফজগড়ের	Nafazgarer
নফজগড়ের	Nafazgarer
অরক্ষিত	orokkhito
খুদেরা	Khudera
পর্যটনমন্ত্রকের	porjotokmontroker
পর্যটনমন্ত্রীর	Porjotonmontrir
বেগুসরাইয়ে	Begusoraiye
পুত্রই	putroi
ব্র্যান্ডন	Brandon
ভরকেন্দ্রকে	Vorkendroke
বোঝেনি	bojheni
বোঝেনি	bojheni
শক্তিরূপে	soktirupe
ইউনিয়নস	unions
হেলমেটটিও	Helmettio
মহারাষ্ট্রতেই	Maharastratei
তবসুমের	tobosumer
স্থানই	sthanoi
ভূতাত্ত্বিক	vutattik
টালাপার্কে	talaparke
আউট্রাম	Outram
রানাওয়াত	Ranawat
আকবরি	akbori
পাসান	pasan
ইয়াসিরের	yasirer
ঢেউ	Dheu
সৌমেনবাবুর	soumenbabur
হঠলেন	hothlen
লেটার্সএর	Letters er
সাপ্লিমেন্টারি	supplementary
লিয়ার	leear
সতীচ্ছদেই	Sotichhodei
সাপই	Saapi
পলাশ	Palash
বাঙ্গার	bangar
মৃচ্ছকটিকম	Mricchokticom
শৌচ	latrine
শৌচ	soucho
১২ঘণ্টা	12 ghonta
উত্তেজনার	Uttenjona'r
২৫৪	254
সাধনাদেবীকে	Sadhonadevike
সোটা	sota
পনীরসেলভমকে	Poneerselvomke
খেয়েছে	kheyeche
বেসিনের	Besin
ঠুকেছিলেন	Beat
ইলেক্ট্রিক্যাল	Electrical
রুটে	rute
রাজাগোপালের	rajagopaler
৯৯৭৯	9979
পেশাদারি	peshadari
দিলবর	Sweetheart
পাস্তা—	pasta-
মেটাকে	mey taake
কোটি	koti
উনতিরিশে	untirishe
হোয়ার্ড	Word
ব্যুমেরাং	Boomerang
রাসলীলা	Raashleela
কিপলিং	Kipling
প্রেমিকে	premike
স্বাস্থ্যভবনেই	Sasthyobhobon-ei
টিকটিকির	lizard's
স্বার্থে	sarthe
মুজফ্‌ফরবাদের	muzaffarabad
পায়নি	Didn't receive
চট্টপাধ্যায়	chattapadhyay
রামধনুর	ramdhonur
আত্মীয়স্বজনরা	attiyosojonra
এসডি	sd
পরিশিষ্ট	porishishto
একত্রে	Ekotre
ওয়াসিমের	washimer
সেশন	session
ফ্যানক্লাব	Fanclub
পাওয়াও	Paoao
বেকারত্ব	Bekarotwo
বাহাদুরি	bahaduri
সবাই	Sobai
তথ্য৷	Tathya
লুসিয়ানোও	bidyaloy
বিদীপ্তা	bidipta
অমায়াকে	amayake
মজেছে	indulged
রুকু	ruku
১৭৩৮	1738
শিক্ষিতের	sikhiter
নষ্টও	Noshtou
পুরসভায	pourosabhai
মিনুজিন	Minuzin
ওয়েস্ট	West
পপি	popy
যৌনবস্তু	sex object
প্রহীরর	Prohiror
খেয়েও	kheyeo
বোমাবাজির	bomabajir
নির্জা	Neerja
সৌগতার	Sougatar
স্নাতক	Snatok
জিৎকে	Jitke
লেপার্ডের	Leparder
পচে	poche
সাজায়—	Sajay
দেবজিত্	debjit
সুহৃদের	Suhrider
समुचित	somuchit
বিঞ্জান	Biggan
নিবেদিতাদেবী	Nibeditadebi
প্যাডি	paddy
আরতিতে	artite
ভাসা	vasha
টাকাপয়সাও	Takapoysao
সিএমও	You
দলগুলিতে	Dolgulite
বম্বস	Bombs
ধূমপানের	Dhoompaaner
পর্রীকরের	porirkorer
দ্বৈতসত্তা	Doitosotta
ওড়াত	Orato
খেলাই	khelai
নাটকীয়তায়	dramatic
হালুম	halum
পৌঁছেও	Pnouchheo
বিস্ফোরিত	bisforito
অক্টোবরেই	october  ei
আইনক্সএর	inoxer
কাপড়ও	kapodo
স্বামীনাথন	Swaminathan
মৌর্যশাসন	Mouryashason
৭২টির	72tir
আম্পায়ারেরা	umpirer
ব্লকই	block i
নদীই	nodi e
ইয়েট্‌স	Yates
অসহয়তা	osohayota
ছদ্মবেশীতে	chhoddobeshite
দীপঙ্করবাবুর	deepankarbabu
হইতে	hoite
হানাকে	hanake
মন্নপুরম	Monnopurom
মৃণালের	Mrinaler
স্কোরকার্ড	Scorecard
বিশ্বএকাদশে	bishwaekadoshe
থুতনিটা	thutniTa
ডুবন্ত	Dubonto
ছোঁয়াচও	Chhowach o
ইকো	eko
কৃষকনেতা	Krishokneta
অনিন্দ্যদা	aninda da
ভাগটুকু	bhagtuku
খালেদার	khaledaar
কুশীলবরা	Kushilobra
উন্নতমানের	Unnotomaner
আকসাই	Aaksai
মুখ্যমন্ত্রিত্ব	Mukhyomontritwo
শিল্পকর্মের	Shilpokormer
শসা	Shosha
শোনার	sonar
সিলেকশন	Selection
শতকের	Shotoker
সমাজবিরোধীদেরও	bara
দুর্গাপুজোর	durgapujor
তৃণমলূ	Trinomool
কিংগ	Independent
জনপ্রাণী	jonoprani
টেনেও	Teneo
রোখার	Rokhar
ট্যাঙ্কার	Tanker
থা	Tha
জড়ায়নি	joraini
পোড়খাওয়া	porkhawa
করদাতা	kordatara
কালীঘাটও	Kalighato
অর্ডিনেশনের	ordinationer
তিনও	Tino
তিনও	Tino
১লক্ষের	1lokkher
পুজোয়ে	Pujoy
সাংহাই	Shanghai
বোধটি	bodhti
পানাজি	Panaji
উত্তরসূরিদের	uttorsurider
১৯৯৪এর	1994er
পুলই	puloi
অংশীদারিত্ব	ongshidaritwo
ঘোষও	ghosho
কেওটজালির	keotjalir
২০০২	2002
এলিমিনেট	Eliminate
ঐতিহাসিকরাও	oitihashikrao
দরিদ্র	Doridro
পঠনরত	pthonroto
প্রশংসিতও	proshongshito
গ্রেনেডটিও	Grenadetio
ছাত্রীকে	chatrike
নিন্দক	Nindok
চাপোকোয়েনসের	Cjapokoyenser
মৌমাছি	Moumachhi
চুম্বক	chumbok
জলদেবী	joldebi
শেহলা	shehola
রাবণবধের	Rabonbodher
রাবণবধের	rabonbodher
জলকেই	jolkei
অ্যাস্ট্রোটার্ফে	astro turf eh
অনুযায়ী—	onujai
মাকড়সা	Makorsha
লাগাও	lagao
সৌদিতে	soudite
ট্যুর	tour
আবদুল্লার	Abdullar
অ্যালাউড	allowed
শবযাত্রা	Shobjatra
ভারতলক্ষ্মী	bharotlokkhi
ডাইন	dain
পোস্টারই	Posteroi
অ্যারন	Aaron
ইনিংশ	innings
পানপাত্র	panpatro
যুবকেন্দ্রে	jubokendre
ওইদিন	oidin
অগ্রগতিতে	Agrogotite
পকেট	pocket
রংপুর	Rongpur
বিচ্যুতি	bichyuti
উপকৃতই	Upokritoi
গোলপার্ক	golpark
কিলোলিটারে	kilolitre
টুকরোও	tukro
যাইয়া	Jaiya
টগবগ	togbog
প্রচিলত	procolito
জাফরিরাও	Jafrirao
রিস্কটা	Riskta
গণেশবাবা	goneshbaba
গোয়ালপাড়ার	goyalparar
তৈরি—	toiri-
আয়ারল্যান্ড	Ireland
কুনকি	Kunki
পোষেন	poshen
সংস্করণই	shongskoron e
পূজোর	Pujor
লক্ষ্মীবারে	Lakshmibare
অ্যাম্বুল্যান্সের	ambulencer
তাপসি	Tapasi
পন্নুকে	pannuke
হাড়	haar
ওয়র্কশপের	Workshoper
ফলওলা	Folwala
দত্তবাদ	dottobad
মৃয়মাণ	Mriyoman
মনস্তত্ব	Monostotto
গডফাদারকে	Godfatherk
কজনের	Kawjoner
নীমেই	nimei
মোদীর—	modir
ওয়ার্কপের	Workpayer
বুকিরা	bookie ra
বিস্ট	Bist
কারশেডে	Karshede
কষাকষিতে	koshakoshite
ডাইনোসর	Dinosaur
বোকামি	Bokmai
সামলেই	samleyi
ট্র্যাজিক	tragic
শশীকান্ত	shoshikanto
বোড়াল	beral
ম্যালেরিয়া	Malaria
শ্রীয়া	shriya
নিরাপত্তামন্ত্রী	Nirapottamontri
ঝলকএর	jholoker
বিকৃতির	Bikritir
রো়ডে	Rodey
তর্পণ	torpon
লিমিটও	Limito
হন্যে	honneh
ভাড়াবাড়ি	bharabari
পশ্চিমীঝঞ্ঝা	poshchimijhonja
‌রাষ্ট্রীয়	Rashtriyo
রাসায়নিক—	Rasayonik
শিক্ষাব্যবস্থা	sikkhabybostha
সোনাঝরা	sonajhara
গোবরে	gobre
আপোস	aposh
দ্বিতীয়	ditiyo
ছশোর	choshor
সত্যব্রতের	sotyobroter
স্লোপ	Slope
রিপোর্টও	Reporto
অব্যবহিত	obyabhit
চালালো	chalalo
স্বপ্না	Swapna
আলুবিজ	Aloobij
চোটটাও	duping
গোছের	Gocher
ত্যাগস্বীকারএর	tyagsikarer
সুখ্যাতিও	sukkhatio
ভেঙ্গারা	vengara
পচাত্তরের	pochattor
একথাই	ekothai
দ্বাদশীতে	Dadoshite
দ্বাদশীতে	Dadoshite
আইনশৃঙ্খলাহীন	ainshringkholaheen
লালরাম	lalram
অ্যান্টিভাইরাস	Anti virus
উফ্	ouf
৪ঠা	4tha
পাগলপারা	pagolpara
শব্দগুলোকে	shobdoguloke
অপেক্ষায়…	Opekhyay
কত	koto
কোমরেও	Komoreo
চলা	Chola
হালহকিকত্	halhakikat
নাহিনা	nahina
অটোবানএও	Autobunao
দক্ষিণবঙ্গ—	Dakshinbongo
দক্ষিণবঙ্গ—	Dakshinbongo
ঘোড়াদের	Ghorader
লোকেশনও	Location o
চোলিও	cholio
মিলক	Milak
রামকমল	Ramkamal
সম্ভবই	somvoboi
সূচনাতেই	Shuchanatei
বিমানবন্দরকে	Bimanbondorke
অট্টালিকার	Ottalikar
ভোটিং	Voting
বিশ্বরেকর্ডই	Biswarecord e
দস্তিদারের	Dostidarer
কিসিকে	kisike
করবেই	Korbei
শয়তানকে	Shoytanke
ভীষ্মের	Bhishmer
খেড়িয়া	Khoria
রাজপুতরা	Rajputra
মাজারও	majaro
দেওয়ানো	deyano
মেললেও	melleo
দশবছরে	doshbochhore
পাওয়ার	Power
জিঞ্জিরাবাজারে	jinjirabazar a
টুর্নিকেট	Turnicate
ফেডারেলের	federaler
মেডোজে	Medose
সেনিয়েও	Senieo
দায়টা	dayta
পরিকাঠামোতে	Porikathamote
ইন্টারন্যাশন্যাল	International
ইন্টারন্যাশন্যাল	international
হায়দরএ	Haider e
বিষণ্ণ	Bishonno
সোডার	Sodar
মাইরি	mairi
উদযাপিত	Udjapito
গুজবে	Gossip
বানাগুলি	Banaguli
বে়ড়েছে	bereche
রসগোল্লা	rasogolla
সুফিসাধকের	Sufi Sadhokder
সাংসদকেও	Shungshodkeo
৪৩১	431
কমবেশী	kombeshi
সতেচনতা	Sachetanata
পাবে—	pare
ইন্টেরিম	Interim
ইন্টেরিম	Interiam
প্রেরণকারীর	Preronkarir
অবিনাশকুমার	Abinashkumar
পিচকারি	Pichkari
সহজতম	sohojotomo
লোকালকেই	localokei
সাঁতারুদের	Santaruder
ইনকাম	Income
নিলে	nile
জটলার	Jotlar
ইন্সপেক্টরকে	inspectorke
বাঁকালেন	bnakalen
তথ্যপ্রযুক্তিতে	totthoprojuktite
ইনবক্স	inbox
বিরোধীদের	Opponent
বগলেও	Bogoleo
প্রাণপাত	pranpat
লুকাকু	Lukaku
স্বর্ণমন্দির	swornomondir
যেক্ষেত্রে	Jekkhetre
ঘটনায়	ghotonay
মুজিবকন্যান	mujibkonnyan
হস্তক্ষেপকেও	hostokkhepkeo
মদনোৎসবের	modonotsober
সমর্পণকে	Somporno keh
লাইব্রেরিরও	libraryro
কৃপাচার্য	kripachrya
কমিউনিস্ট	Communist
মিত্তির	Mittir
তোলা	tola
পৃথ্বীকে	prithbIke
আলোচ্যসূচিতেও	alocchoshuchiteo
শালীনতার	shalinotar
রাজ্যজয়ের	rajjojoyer
প্রাণোচ্ছ্বল	pranocchol
ম্যানিকিনের	myanikiner
জন্মদিনগুলো	Jonmodingulo
ফলভোজী	Folbhoji
ট্র্যাকিং	Trekking
নেপালিও	Nepalio
ফ্যাশনেব্‌ল	fashionable
অ্যাকিউট	Acute
অটোনমাস	Autonomous
সেজে	seje
প্রার্থনার	Prayer's
শুনশান	Shunshan
নাটোর	natore
পট্টনায়ককে	pottonayokke
হবেও	Hobeo
কথাটুকুই	kothatukui
কয়েকের	koyeker
কয়েকের	Koyeker
ছেলেমেয়েরাও	chele meyerao
ঠান্ডাকেও	Thandakeo
২০১১সালে	2011 saale
কর্মীরই	Kormiri
বিনামূল্য	binamulyo
চোখরাঙানি	Chokhrangani
সায়েশা	Sayesha
ওয়াহিদা	Wahida
ঠাট্টাচ্ছলে	Thattachchhole
গলাগলিতে	Golagolite
সাপের	Saaper
মেলাবেন	Melaben
জ্বালিয়েও	Jwaliyeo
হাবুল	habul
ইইই	EEE
পেটে	pete
নাটকের	Natoker
চিতালে	Chitale
প্রবচন	probochon
রাজেন	rajen
প্রক্রিয়াটা	prokriys ta
চ্যাপো	Chyapo
বেড়াজাল	berajal
সুশান্তবাবুর	sushantababur
ছন্দে	chhonde
ছন্দে	chonde
কিনাস্পষ্ট	Kinasposto
হয়েইছে	hoyeiche
আরপি	aropi
জেগেছিল	jegechhilo
উদ্ধারকেন্দ্রে	Uddharkendro
জিমন্যাস্টিক	Gymnastic
দমের	Domer
ডেকেছেন	Dekechen
চান্দু	Chandu
মেট্রোও	Metro O
ঘটনাক্রম	Ghotonakrome
তালাহা	Talaha
আশ্বস্থ	asostho
সেকাল	Shekal
দিলীপবাবুদেরও	Dilipbabudero
মুডের	Muder
বিমানবন্দরেই	biman bondorei
সোপোরে	Shopore
ত্রিবর্ণ	triborno
ভুমিকা	Introduction
আরিফুল্লা	Arifullah
ফোক	folk
ফোক	folk
তাহেরের	taherer
টুম্পাকে	tumpake
ফ্যানবক্স	Fanbox
মর্গান	Morgan
নজদারি	nojdari
জিম্বাওয়ে	Zimbabwe
শুটিং	shooting
অবতরণকে	obotoronke
ভর্তসনা	Vortsona
গোমাঙ্গর	Gomangor
ধারেনি	Dhareni
বিজ্ঞানী	bigyani
সভাটি	Sabha ti
নিয়েছিস	niyechhish
সুদু	sudu
আন্দালুশিয়ান	andulusian
নিরীক্ষাও	Nireekkhao
দেখিয়েছিলেন	dekhiyechhilen
চিংড়িঘাটায়	chingrighatay
রাখঢাক	Rakhdhak
ঢালাইয়ে	dhalaye
নস্ট্যালজিক	nostalgic
অভি‌যোগের	Obhijoger
ছেড়ে	Chhere
সাবমেরিন	submarine
ক্রিকেটই	Cricketi
প্রতিযোগিতার	Protijogitar
বললনে	Bollone
রাঘবেন্দ্র	Raghabendra
ভক্তকূল	Bhoktokul
পুদিনাপাতা	Pudinapata
নামাচ্ছে	namachhe
গোলাম—	golam
নান্টি	nanti
লোগানের	Loganer
‌যানই	Jan i
বয়েসেই	Boyeshei
নাট্যকারের	Natyakarer
স্বৈরাচারীর	Swoiracharir
এলিস	elice
হয়তও	Hoyto
পড়লেন	porlen
বদলটা	bodolta
পাতলেও	Patleo
সেফের	safe er
পর্যালোচনাই	Porjalochonay
ইরানিকে	Market
খেলবেনই	Khelben e
বেনে	bene
অর্নাস	honours
এমারজেন্সি	emergency
নাদিয়াকে	nadiake
বাঁচায়	bachay
মূত্রত্যাগে	Mutrotyage
ঘুমনো	Ghumono
প্রথাই	protha e
মেলানো	melano
জানিয়ে়ছিল	janiyechilo
আত্মাদেরও	Afterlife as well
ইউনাইটেডকে	united k
চালচিত্র	Chalchitra
ফিন	fin
হেলাফেলার	Helafelar
মজুমদারের	Majumdarer
নওয়াজ়	nawaz
হেভেন	heaven
৯৯	99
অ্যাডভেঞ্চারপ্রিয়	adventurepriyo
দৃশ্যমানতার	Drishyomanotar
শেমিংকে	sheymingke
দাগগুবাতি	dagubati
উনাদকট	Unadkot
তেঘরিয়া	Teghoria
কৃষ্ণগঞ্জের	Krishnoganjer
প্রেমিকারা	premikara
ব্রাজিলে	brazile
ট্রপোস্ফিয়ার	Troposphere
মেহতাবকে	Mehetabke
খুলনা	Khulna
পকেটও	Pocketo
পেটালো	petalo
পালংদারকেও	palongdarkeo
সময়ের	Somoyer
অবস্তাব	obastob
নাহা	Naha
গ্রামছাড়া	Gramchhara
তন্ময়কে	Tanmoyke
লাড্ডু	Laddu
আয়েশা	Ayesha
ভাসিয়েছিল	Vashiyechilo
করাও	korao
পিতৃপরিচয়	pitriporichoy
গ্রাফিক্স	Graphics
কনট্রেরাস	Contreras
প্রিয়ঙ্কার	priyankar
ডিরোজারিও	Biswakobi
চর্চিত	Chorchito
পুনর্দখলে	Punordokhole
চারণা	Charona
ঘাটছে	Ghatchhe
শাস্তিরই	shastiri
বিত্ত	bitto
তেন্ডুলকর—	Tendulkar
জন্মজয়ন্তীতে	Jonmojayantite
দিদিমনি	didimoni
বিন্দুবিসর্গও	nothing
মদ্যপান	modyopaan
চারজনকে	charjonke
ফ্যাটবয়	Fatboy
রেস্তোঁরা	Restaurant
আজহারই	ajhari
পুনর্বব্যহার	punorbebohar
টুকড়ে	tukre
উল্কাপতনে	ulkapotone
দুর্গতির	Durgotir
পাইতেকে	Paiteke
হরিরামপুরের	Horirampur er
প্রিন্সিপাল—সহ	Principal-soho
অণ্ডালে	ondale
১৯৭৬	1976
১৯৭৬	1976
১৯৭৬	1976
দেখালো	Dekhalo
হুল্লোড়ের	Hullorer
জেনারেশন	Generation
রোমাঞ্চে	romanche
আড্ডাধারী	addadhari
নিয়মকেই	Niomkei
চরিত্রেরও	choritrero
মুখ্যমন্ত্রীরাও	mukhomantrirao
সভাই	Sovai
কর্তাকেও	Kartakeo
যোগরাজ	Yograj
ম্যাক্সকিয়োর	Maxcure
দেখে	dekhe
বজ্রাঘাত	Strike by lightning
আইডিএফ	IDF
ছেড়েনি	chereni
মতে—	mote-
টানেলিং	Tunneling
যৌনপল্লির	Jounopollir
নাগেশ	nages
মরসুমটা	Morsumta
ব্লাঁ	Blna
ব্যক্তিও	Bekti-o
সোবুকোভা	Sobukova
লুকিয়ানোভা	talented
খানপুরের	khanpurer
মধুবালা	Madhubala
পাটবাড়ি	Paatbari
লুফথানসা	lufthansa
মুগ্ধতা	Mugdhota
কৃষ্ণপ্রসাদবাবু	Krishno proshad babu
রাধা	radha
রাজেন্দ্রসিংহ	Rajendrasingha
দ্বিবেদি	Dwibedi
পটহোল	Pothole
ইনশাল্লাহ	inshallah
স্তনদায়ী	Mammal
সামসেরগঞ্জ	Samsherganj
স্ট্যাসি	stacy
স্ট্যাসি	stacy
হওয়াতেই	howatei
গেয়েই	geyei
ঢাকনা	Dhakna
ময়নাতদন্তকারী	moynatodontokari
বরফঘরে	borofghore
মধ্যরাত	Moddhorate
বিশ্বব্রত	Biswabroto
বন্দলাপল্লি	bandalapalli
প্রয়শই	Prayoshoi
আবস্থার	abashthar
যোগানের	joganer
মিশবে	mishbe
মহান্তি	mohanti
সোর্সদের	Sourceder
ভব্যতা	Vobyota
প্রাপ্তের	prapter
প্রাপ্তের	prapter
তেরোতেই	Terotei
আত্মসমর্পণ	Aatmyoshomorpon
শাশুড়িও	Sasurhio
ফ্যাক্সে	fax e
পচতে	pochte
ওয়াচটাওয়ার	Watchtower
ক্রান্তি	Revolution
হন	hon
তর্কবিতর্ক	torkobitorko
রমানাথের	ramanather
আসাটাও	Asatao
আকবরকেও	Akbarkeo
গয়াল	goyal
উডি	Woody
মাইসোরকে	maisorke
রশিদও	roshido
রূপম	rupom
ফ্যানাটিক	Fanatic
মত্‍স্যপ্রেম	motshoprem
এনএইচআরসিএল	NHRCL
ওয়াটকিনস	watkins
ঝাড়খণ্ডকে	jharkhand ke
ভানুভবন	Bhanubhaban
পাঠিয়েছিল	pathiyechhilo
পঞ্চানন	ponchanon
হোয়াটস	whats
হোমমেকারের	Homemakerer
টাকাতে	Takate
তপু	topu
দানী	Dani
কমান্ডকেও	commandkeO
ব্যাপারে	byapare
কহতে	kohote
ঘটকের	Ghotoker
প্রেসিডিন্টের	Presidinter
প্ল্যানটা	planta
মাহাদেবের	Mahadeber
জিনপিংয়ের	Xinping er
১০০টাকা	100 taka
হায়দরবাদের	Hyderabader
বিশ্বনাথের	bissonather
প্রাত	Prato
শুঁড়ে	Shure
গডকড়ীও	godkodio
ভিভান	Bhibhan
তোড়জোড়	torjor
সম্মতি–সহ	sommoti-swoho
বার্নপুরে	barnpure
কচ্ছি	Kochhi
গাঙ্গুলিবাগানে	gangulybagan a
গ্রাফিটি	graffiti
কৃপালাভের	Kripalabher
ইভ্যাকুয়েশন	ivaluation
ফারহা	Farha
পেনসিলভেনিয়ায়	Pennsylvaniay
তাহির	Tahir
মাপলেন	Maplen
জিটিএর	GTA er
ভিসনাগরে	Visnagore
পর্বতারোহীকে	porbotarohi keh
পর্বতারোহীকে	porbotarohi keh
দূরান্তে	Durante
জিমেই	Jimei
তুষ্ট	Satisfy
ছুঁয়েছিলাম	chhuyechilam
কমিটিও	Committee o
ভেলেনটাইন্স	Valentine's
মোর্চারা	Morchara
জেনাইটিসের	jenasaitiser
বীরপুরুষ	Birpurush
আল্ট্রা	Ultra
সমীর	Samir
যাত্রসুরক্ষার	Jatrosurokhsar
লেটারে	letare
বুঝিতেও	Bujhiteo
কৃষণের	krishoner
মেডিক্যাল	Medical
টুম্ম	Tummo
অশ্নীল	Oshlil
উত্‍সবে	utshobe
কৃষ্ণেন্দুবাবু	Krishnendubabu
অনসম্বলের	Ensemble'er
বলবেন—	bolben
কমানোর	Komanor
জগদলপুর	Jagdalpur
লতাপাতার	lotapatar
মেরিজ	Mary's
গ্ল্যামারের	Glyamarer
চলটা	Cholta
মজবেন	mojben
শবরীমালায়	Shoborimalay
চালাবো	chalabo
বনধে্‌র	Bondher
বনধে্‌র	Bondher
বিদ্যাধারা	bidhyadhara
মূলি	muli
ডিসঅর্ডারও	Disorder o
কুমারটুলির	kumartulir
বেড়ে	bere
শিয়াকে	siyak
নগেন্দ্রের	nagendra
ছোটছেলে	chhotochhele
শীততাপ	sheetotap
ফেলোশিপ	fellowship
জেনেও	jeneo
গ্লাভসে	glovese
লোগোঅলা	logowala
নাহাতা	nahata
অংশকেও	Angshoke
জোরদার	jordar
বিহারী	Bihari
চিত্র	Chitra
চিকিৎসকদের	chikitshokder
‍সেতু	Setu
কন্যাকে	konyake
কলকাতাকেও	kolkatakeo
মোদীগলিতে	Modigolite
এস	S
প্রতিদ্বন্দ্বিতার	protidwonditar
দেখেননি—	Dekhenni
মাখোমাখো	makhomakho
ম্যাজাগন	Myajagon
লালমাটির	Laalmaatir
তারকাদ্বয়কে	Tarokadyayke
বিভাবতী	Bibhaboti
লেনদেন	lenden
পিআরটি	PRT
উঠেছে	utheche
বিনায়ক	Binayak
চিকেনগুলোয়	Chickenguloy
বাপের	Baper
সাথে	saathe
কাউন্সিলরা	councilorera
অটোচাকের	autochaker
দংশনের	dongsoner
লত	Loto
বন্দুকবাজিও	bondukbajiO
করেও	Koreo
হরিশচ্যাটার্জি	horishchaterjee
রিচার্ডস	Richards
রাজাবাজার	Rajabazar
টিনটিনের	tintiner
কায়েমের	Kayemer
বিল্ড	build
বাঁকের	bnaker
দুর্গাপূজার	durgapujar
বৈতরণীর	Boitoronir
কেষ্টকে	keshtoke
ডলি	doli
রবারের	Robarer
মিনেসোটার	minesotar
ব্যাচেলার	bachelor
মাঝরাস্তায়	Majhrastay
সম্পাদকীয়	Sompadokiyo
অতিথিপরায়ণ	Otithiporayon
শেওয়ালের	shewaler
গ্ল্য়ামার	golyamar
তিক্ততা	tiktota
প্রবাহের	probaher
ফোব	Fob
কিসক্যাম	kisscam
স্পাইডারম্যান	Spiderman
যুবভারতীতেই	jubovarotitei
বে়ডরুমের	bedroomer
অসম্মানই	osommani
তাজেল	Tajel
ঘুরবে	Ghurbe
বিক্ষোভে	bikkhobhe
দৈঘ্য	doirghyo
পরিবেশিত	poribeshito
জাকিরকে	Zakir ke
আবছায়াতে	abchayate
বেশকয়েকজনের	beshkoyekjoner
মণিদুটোর	Monidutor
পোষ	posh
ইনোগ্রেশনে	Inauguration a
অর্ধেকও	ordhekeo
পূরব	purob
১৯৪৬	1946
১৯৪৬	1946
এমভি	MV
টিমোথি	Timothi
চরিত্রনির্ভর	choritronirvor
উসেইন	Usain
অ্যাপোলোয়	apolloy
দিকটিও	diktio
পোপকে	Popoke
১৮২১	1821
আয়োজনে	ayojone
রিমার্কসও	remarks o
সোয়াঙ্ক	soyank
দেবত্ব	Debotto
জোহরেরও	johorero
বিষক্রিয়া	bishokriya
মিথ্যার	mithyar
ওয়াইফাইয়ের	Wifi er
নেতানেত্রীকে	Netanetrike
উছ্বসিত	ucchoshito
ছাঁটা	chata
শুভেন্দুদাকে	Suvendudake
সংশোধানাগার	Shongshodhanagar
বিনিকেই	Binikei
প্রস্তুতকারকদের	Prostutkarokder
কৃষ্ণপক্ষের	Krshnapoksher
আসরের	ashrer
বিকল্পনীয়	bikolponiyo
বাহিনী	bahini
ক্রিটিসিজ্‌ম	criticism
বেসক্যাম্পে	basecampey
বেসক্যাম্পে	Basecampe
সচিবও	Sochibo
রিচার্ডের	Richarder
দাভোলকরের	Dabholkorer
বিশ্ববিদ্যালয়েই	biswabidyaloyei
সামগ্রীই	shamogrie
খড়্গপুর	kharagpur
বন্দুকবাজ	Bondukbaj
নামেও	nameo
বোলালাম	Bolalam
দেখাই	dekhai
হিসেবই	Hisebei
অসেতুসম্ভব	Asetusombhob
ম্যাসকটের	mascoter
বিশ্ববিদ্যালয়গুলির	biswabidyaloygulir
উবেই	Ubei
প্রকল্পগুলিও	Plans
কুমড়ি	Kumri
সেমিওলজি	Semiolis
সারমেয়রাই	sharomeyorai
রাজনীতি	rajneeti
ব্র্যাঞ্চ	branch
পরিত্রাণ	Paritran
দীঘায়	Dighay
রোগটাকে	rogtake
দাঙ্গায়	Dangay
চন্দ্রশেখর	Chondroshekhor
ঘসে	ghoshe
বিন্যাসের	binyaser
নিরূফা	nirufa
প্রেমজি	Premji
৭৫৬	756
পালানো	palano
ফুলকে	fulke
কালেকশনে	Kaalekshane
GSTর	GSTer
আদর্শগতভাবে	adorshogotovabe
বেঁধেছে	bendhechhe
ক্রোশে	Kroshe
পৌরোহিত্যে	Pourohityo
শেকলবন্দি	Sekolbondi
শিল্পদ্যোগীরাও	Shilpodyogirao
সুবন্দোবস্ত	Shubondobosto
দিত	Dito
সেন্ডারের	senderer
বৈচিত্রময়	Baichitromoy
রকমই	rokomoi
নাচমহল	nachmohol
থ্যাঁতলানো	Thnatlano
ব্রজেশ	Brojesh
সবুর	sobur
সমকালীনদের	Shomokaaleender
মারারও	maaraaro
প্রতিবেদকের	Protibedok'der
কৃষক	krishok
ভ্যালিদাই	vallidai
তাঁবুর	tabur
ভোগান্তিু	Bhoganti
দেখলেই	dekhlei
লেসকিয়ান	leskian
স্বপ্নপূরণ	sopno puron
আশ্বস্তই	Ashwastoi
আনওয়ার	Anwar
প্রাপ্তিকে	praptike
মূলঅভিযুক্ত	mul obhijukto
দিদিমণিরা	Didimonira
ডার্ক	dark
নীরাংশুবাবু	Nirangsubabu
নরেশবাবুর	Nareshbabur
কনসার্টও	Concerto
মাধ্যমেরই	madhyomeroi
দাওয়াইয়ে	dawaiye
ধনেখালি	dhonekhali
গোলশিকারী	gol shikari
ফুলফর্মে	fullformeh
ছটা	chhota
ব্লাটার	Blatar
প্রোমোটারিও	promoterio
পেন্ট	paint
হাওড়াগামী	Howrahgaami
বছরটাই	bochortai
কমিশনারেটেও	komishonareteo
মানিকমালা	manikmala
তোদের	toder
তোদের	toder
বাকি	Baki
স্পিকার	speaker
পালাচ্ছে	palcche
ঘোরাও	ghorao
একজোট	ekjot
ক্রোরস	Crores
ময়ূরেশ্বরে	Mayureshwar a
বুথফেরত	Boothferot
শর্মিষ্ঠা	sharmishtha
বাদর	Bador
হেডফোন	headphone
হাসিমুখে	hasimukhe
দন্ড	dondo
ফ্লেয়ার	flayer
মেঘরাজ	meghraj
পদও	podh oh
ভিন্নতার	bhinnotar
জুড়ল	Jurlo
ঢালো	Dhalo
গান	gaan
কড়ভি	Korobhi
জোগাবেন	Jogaben
সেমেন	semen
ব্যাড	bad
জিততে	jitte
উষ্মার	ushmar
জাভেদজি	javedji
কারিগরকেই	Kaarigorkei
বরোদা	Baroda
অতই	Otoyi
বটে॥	Bote
ডেষ্টিনেশন	destination
হত্যাচেষ্টায়	hottacheshtay
১০২	102
বেকারত্বের	bekarotter
এমডিএস	MDS
এমডিএস	MDS
ডিপোজিটে	depositey
ফেড	Fed
বাক্‌স্বাধীনতায়	bakswadhinatay
বাক্‌স্বাধীনতায়	bakswadhiontai
রিয়েলটি	realty
ক্রিকেটারেরও	Kriketerero
খস়ড়া	khosra
পাপিয়াকে৷	Papiyake
রেশমবাগে	Reshombaage
কুস্তিগীরদের	Kustigirder
হ্যান্ড	hand
দাবিগুলির	dabigulir
ভিডিওগুলিতে	videogulite
ষাটপশলায়	Shatposhlay
জালিম	Jalim
যুথিকা	Juthika
সরোবরকে	soroborke
করতালি	Kortali
মার্কাস	marcus
আম্বিয়ার	ambiyar
পেটালেন	petalen
পায়াস	Payas
বসিন্দার	basindar
সমবেদনা	somobedona
দৌড়োদৌড়িতে	Dourodouriteo
কর্মাশিয়াল	commercial
চারে	chare
জঙ্গলটাই	Jongoltai
নির্মম	Nirmom
রেবতি	reboti
পালনীয়	palonio
এখানকারই	ekhankar e
মিরজিয়া	mirjiya
৮৩তে	83te
তালকানা	Talkana
এসটিইএ	STEA
ভিত্তিতে	Bhittite
ভাবাও	Bhabao
গুজ়ম্যানকে	Gujmanke
ভীষণভাবেই	Bhishonbhabei
বিদ্যাপতি	bidyapati
আইনসভা	ayinsobha
পাল্টাইনি	paltini
হরিয়ানা	haryana
নেত্রালয়ের	Netralayer
নেত্রালয়ের	Netraloyer
রোববারের	Robbarer
ঘেরাটোপ	Gheratop
লেহেঙ্গা	lehenga
খোলেন	Kholen
খোলেন	Kholen
ঊর্মিকে	urmike
ড্যামিয়েন	Damien
দত্তই	Duttoi
বাগিচায়	bagichay
বাগিচায়	bagichai
উমতিতি	umtiti
সিরীয়	syria
বর্মাকে	Bormake
নৌকাবিহার	Noukabihar
গরগর	Gorgor
নলিন	Nalin
গানটা	Gan ta
অগভীর	Ogobhir
রে়ডমেন	Redmen
গিনি	Gini
মেরুদণ্ড	merudonda
স্তরকে	storke
মারফতে	through
স্বত্ত্ব	shottyo
রিগিং	Rigging
৩৩০০	3300
অফিসারকেও	Officerkeo
দ্বর্থ্যহীন	Dworthyohin
লাইক্‌স	likes
সেনেটরদের	senaterder
নিগৃহীত	Nigrihito
গিলমার	Gilmar
হুইস্কি	huiski
কুস্তিগিরদের	Kustigirder
অনুপমকেও	Anupamkeo
জয়ন্তনারায়ণবাবু	jayantanarayanbabu
সিন্ধায়াপাড়ার	sindhiaparar
দিকি	Diki
প্রাণীটি	praniti
আপস	Apos
শন	shon
পিটিয়েই	beat
চৈনিক	Choinik
গঙ্গাপুজো	Gongapujo
মুখোপাধ্য়ায়—	Mukhopadhyay
গোকুলে	Gokule
BJPনেতা	BJP neta
ছোটগল্পেরা	Chhotogolpera
২৬০৫	2605
ফুটিয়েছে	Phutiyeche
চমকও	Chomoko
পুঁড়ি	Punri
কানাঘুষোই	Kanaghushoi
মাঝবাটে	Majhbaate
সফরটা	traveling
তোড়াই	torai
শহরতলির	shohortolir
২০৭টি	207 ti
৪০০জন	800 jon
খারাপগুলো	Kharap gulo
কর্মকর্তারাও	Kormokortara
হোমটি	homti
হার	har
কোলাপুর	Kolapur
এলিয়ে	Eliye
বৃন্দাবনের	Brindaboner
ফুলমালা	Flower garland
ক্রী়ড়ামন্ত্রক	Kriramontrok
চ্যান	chan
গুজগুজ	Gujguj
গুজগুজ	gujguj
প্রজ্ঞান	progyan
জয়াংশু	Mr Jayangshu
ধনকুবেরদের	days
সুফলটা	Sufolta
রাজ্যপালরাও	rajjyapalrao
পাথরা	pathra
কয়ে‌কটি	Koyekti
জলাধারটিতে	jolodharatite
পুব	Pub
আল্ট্রাস	Ultras
মারিনি	Maarini
টার্মিনালে	Terminale
শিশু‌কে	shishuke
প্রেশাস	Presas
ভ্যাটেও	Bhateo
মাফলার	Muffler
নলীন	Nolin
পেরেক	perek
আইডিয়া	Idea
নেহরাকে	nehrake
১৬৪০	1640
নিকাহনামাতেই	Nikahnamatei
হন্টেড	haunted
গৃহবধূকে	grihobodhuke
ওরিয়েন্টাল	Oriental
খতিয়ানও	khatiyano
সোলিয়াম	solium
সুন্দরীকে	Sundarike
অ্যাকসিডেন্টে	Accident
মেকানিকস	Mechanics
ড্রাম্‌স	drums
রক্তকরবীর	Roktokoborir
কিংকর্তব্যবিমূঢ়	kingkortobyobimur
মানবিকতা	manobikota
নবাজাতক	nobojatok
গড়িয়েও	goriyeo
আমাদের	Amader
শুভ্রকান্তি	shubhrokanti
ভূষণবাবু	Bhushanbabu
খাদ্যপণের	khaddoponner
শোরুমেরও	showroom eo
শ্রেষ্ঠদের	Sresthoder
জড়িয়েছে	joriyeche
আফ্রিদিরাও	Afridirao
মহেন্দর	Mahendar
রিসার্চএর	researcher
মিন্টু	Mintu
বিঞ্জানী	bigyani
সোয়াইপড	Swiped
ভর্তিকরানোর	bhortikoranor
দ্রবীভূত	drobibhuto
ট্যাক্সিই	Taxi e
বাহিনির	Bahinir
অন্য়ান্য	Onyanyo
রাহুলবাবু	Rahulbabu
জেসন	Jeson
এনডিএফবি	NDFB
নাতিপুতিদের	Natiputider
রণ	Rono
শেইখ	Sheikh
আর্তনাদে	Artonade
আসরাফুলকে	Aasrafulke
রুমানি	rumani
অ্যালবামের	Ayalbamer
বৌবাজার	Boubajar
ভূমিপুত্রের	bhumiputrer
বিভাগ—	Bibhag
আইএএস	IAS
পারভেজের	Parvejer
পাটকেই	Patkei
এটিএমের	ATMer
বালিঘাটার	Ballyghatar
ভাস্করবাবুও	bhashkorbabuo
সুহানি	suhani
চেয়ে	cheye
অভিবাসনের	Abhibashoner
তাড়াতে	tarate
বহিরাগতের	Bohiragoter
চিকিৎসকে	chikitsok
সিংলা	Singla
সংঘর্ষবিরতিও	Shonghorshobirotio
মোহনপুরে	Mohonpure
ল্যাংডনের	lyangdoner
সাতাশ	Satash
ক্যামেরাগুলি	Cameraguli
ডিসেম্বর	december
আঠাশের	athasher
কল্যাণেশ্বর	kolyanessor
দৌড়বীরেরও	Dourbirero
কার্ডের	card er
কোটাক	kotak
গতকয়েকদিন	gotokoyekdin
য়া	Ya
দলবাজি	dolbaji
ভোলানো	Bholano
অভিযুক্তেরও	obhijukter o
সোয়েশবারি	soyeshbari
আর্সেন	Arsen
অমরনাথের	Amarnather
টেকনিশিয়ানের	Techniciander
পেঁয়াজকে	peyajke
চিত্রনাট্যেও	chitronatyeo
জীবনদর্শনের	jebondorshoner
তৈলাক্ত	toilakto
হারসেল্ফ	herself
বিপ্লবদিন	biplobdin
লিবর্তে	liborte
ঠান্ডার	thandar
আহ্বানও	Ahwan
পার্লামেন্টেরিয়ানস	parlamenterians
ঢেলেছিল	dhelechile
মার্লন	Marlon
পরিষদীয়	Porishodiyo
রাধাবল্লভচক	Radhaballavchak
যুদ্ধবিমানগুলি	judhyobimanguli
মাঝরাত্রে	Majhratre
জাফরের	Zafarer
সারল	Sarol
রোকা	Roka
হাড়গোড়	haargor
রাইম	rhyme
মোহনবাগানেরই	Mohunbaganeri
আসবাব	Ashbab
সিরিয়ালেই	Serialei
নারদাকাণ্ডের	Narada kandeh
মোড়গুলিতে	Morgulite
মহানায়িকার	Mohanayikar
ইনিংসেরই	Innings eri
তুলছে	Tulche
বাটারফ্লাইতে	Butterflyte
ছাড়াও	charao
নাৎসিরা	natsira
কর্ণএ	karna o
বিবাদমান	Bibadman
ঐশ্বরিক	Oishwarik
অ্যাতলেতিকো	atletico
করপুরকায়স্থ	korpurokyestho
সুভাষ	subhash
তৈরির	Toirir
অন্ধকারেই	ondhokarei
তরি	Tori
বিশ্বাসী	biswashi
ইউপিএসসির	UPSCr
করুণারূপী	Karunarupi
টাওয়েল	towel
সোকোর	Sokor
সুখ্যাতিই	Shukkhyati-ee
অ্যাম্বুলেন্সও	Ambulance o
কেবিনেও	kebineo
তৎপরতা—দুইয়ের	totporota-duiyer
বয়ানেই	boyanei
অন্তর্বতিকালীন	Ontorbortikaalin
বাংলাদেশর	Bangladesher
মিলিঝুলি	milijhuli
আদ্যাপীঠে	Jewel
একাংশকে	Ekanshoke
সাকূল্যে	sakulye
অবসাদের	Oboshader
ফিল্ডার	filder
নাটুকেপনা	natukepona
খোঁচাতে	khonchate
পরনের	poroner
প্যান্টসের	Pants
ব্যাটালিয়ানের	Battalionder
চুঁচুড়া	Chuchura
স্যান্টোসকে	Santos ke
মন্দীভূত	Mondivut
স্পর্শকাতর	sensitive
রোষানলে	roshnole
এওপিএল	AOPL
সাধারণত	Sadharonoto
সাধারণত	sadharonoto
জন্মেছি	jonmechhi
আত্মঘাতে	Atmoghatey
পরিকল্পিতভাবেই	porikolpitovabei
প্রচণ্ডভাবেই	prochondovabhei
প্রান্তরও	Prantorei
সচিবালয়েই	Sachibalayei
কিন্ডারগার্টেন	kindergarten
রোজগার	rojgaar
বাক্যটা	bakoyota
অথোরিটি	authority
রাজনীতিকরণও	Rajnitikorono
মনীন্দ্র	Manindra
বাহুবলীকো	bahubaliko
পিঠটা	Pithta
উলুবেড়িয়াতেই	uluberia tei
লাল–হলুদের	Lal-Holuder
উঠবে—	Uthbe
এরইমধ্যে	erimddhe
স্বয়ংসেবকের	soyongseboker
সৌরভ	Sourav
মর্ফড	morphed
দমনপীড়নের	domonpironer
অরাজকতায়	orajokotay
ঘাইও	Ghaiyo
কিশোরীদের	Kishorider
জীবন	jibon
ঠেকালেই	Thakalei
তরিকাটা	tarikta
মিউজএর	Mujer
গিক্সার	Gixaar
অরুমুগা	Orumuga
সাতান্ন	satanno
ডরতা	Dorta
ক্ষেত্রগুলিতে	Khetrogulite
উপহারকেও	Upoharkao
সুইমওয়্যারগুলোর	Swimweargulo
তাড়াবে	tarabe
এবংসেই	ebongsei
কালচে	Kalche
কীর্তিকলাপের	Kirtikolaper
বাহুবলীদেরই	bahubolideri
দশরথ	Doshroth
মূর্তির	murtir
স্টাফরুম	Staffroom
পাওলি—	Paoli
ভবিষ্যৎ	Bhobishshot
অনিচ্ছুক	onichchuk
সহস্র	Sohosro
সিটিস্ক্যান	CT scan
উত্কন্ঠা	Utkontha
মায়েরাই	Mayerai
কাঁপিয়েছিল	kapiyechilo
জামাত	Jamesat
পেলো	pelo
বেলজিয়ামও	belgiumo
লোবেন	Loben
৬৪৮	648
সবুজদ্বীপকে	sobujdipke
ক্লোজড্‌	Closed
চাকরিটাও	chakritao
পৃথিবীটাতে	prithibitake
ক্রিকেটজীবন	cricketjeebon
ঝাপ	Jhaap
নিহালনি	nijalni
মুখপাত্রের	Mukhopatrer
ফরমানেই	Formanei
স্টর্মি	Stormy
ক্রোম	chrome
আপ্যায়নের	apyaoner
সেলিমেরও	Selimero
ডিএমদের	DM der
সিআরসেভেনকে	CR7ke
শিবরাজ	Shiboraj
বিবদমান	Bibodoman
পোলার্ডও	polardo
ধর্ষকরা	Dharshokra
১৩৫টি	135ti
দাবদাহে	Scorching
প্রত্যাবর্তনকেও	prottabortankeo
ক্ষেতের	Kheter
দ্রষ্টা	Drosta
জেমসের	James er
আনুষ্ঠানিকভাবে	Aparijapto
সূর্যালোক	surjalok
ইব্রাহিমোভিচ	Ibrahimovich
রূপসি	rooposhi
বাঁচান	Baanchan
সাটের	Sater
বাধ্যবাধকতাই	Compulsion indeed
বুকে	Buke
পরীক্ষিতভাবে	Porikhitobhabhe
খেলোয়াড়সুলভ	Khelowarsulov
বিশ্ববিদ্যেলয়ের	bishwobidyeloyer
বালকটিকে	baloktike
কাটাকটি	katakati
পারদর্শিতা	parodorshikota
নেগিটিভ	Negative
ভাস্করের	vaskorer
ট্রফিপ্রাপ্তির	trophy praptir
আনপাড়া	Unpara
সিইওর	Sewer
মঘেরিনি	mogherini
বিশ্বাসঘাতকতায়	Bishwashghatokotay
মিটারে	Metere
ভৌতিকতা	Voutikota
অক্টোপাস	octopus
জুলিয়ান	Julian
সামর্থ্যের	Samorthya
ব্যবহারকারীদের	byaboharkarider
গম্বুজের	gomvujer
খুঁজেছিলাম	khujechilam
শিক্ষকদের৷	Shikkhokder
সিদ্ধান্তকেও	sindhantokeo
লণ্ডভণ্ড	londobhondo
নিজেরাই	nijerai
জড়ানোটা	JoRanota
ডিলার	Dealer
সমুদ্রপৃষ্ঠ	Somudroprishtho
মুজাফফরনগরের	Mujaffornogorer
ডিমা	dima
ফোড়ন	Phoron
মাইগ্রেনডিসার	Mygraindiser
ব্রহ্মা	bramha
রানটিতেই	Runtiteo
উদ্যেশ্যে	uddesshe
ক্ষতস্থান	Khotosthaan
ডায়রিয়ায়	Diarrhea e
मोदी	Modi
পৌরসভা	Municipality
রাবাদা	Rabada
ছুটতে	to run
পারঙ্গমেরা	parongomera
ছুটেছে	Chuteche
সামনায়	Samnay
গায়ত্রীদেবী	Gayatri Devi
যুবারজ	Yuvraj
বাচ্চাকে	bachhake
উত্তরপত্রেই	uttarpotrei
অামেরিকার	americar
সাবওয়ে	Subway
স্ট্রাকচার্ড	Structured
আমেজিং	amazing
অথিরিটি	Authority
গুদামে	gudame
বানিয়া	Fake
মাদুরাই	Madurai
গ্যালনের	gyaloner
ইংরিজি	English
সং	Shong
বৃদ্ধিটা	The growth a
অ্যালাওয়েন্সেস	Allowances
বেদিয়াপাড়ার	bediapara
চব্বিশঘণ্টায়	chobbishghontay
দাসও	Daso
দাসও	Das o
ঝাঁপ	Jhanp
পুরমাতা	Puromata
বগলে	Bogole
চরণে	Charane
নিশ্চিম্ত	nishchinto
ফড়ণবীশকে	Foronbishke
শোনাচ্ছেন	Shonachchhen
অবস্থায়	Obosthae
কৃতকর্মের	kritokormer
জিঞ্জাসাবাদের	Jiggasabader
প্রফুল্লবালা	Profullobala
পুনঃপ্রতিষ্ঠা	punohprotistha
কেনাটা	kenata
কেনাটা	kenata
ভাবন	Vabon
সপ্তর্ষিরও	soptorshiro
ফ্লেক্সগুলি	Flexguli
প্রহরীরা	Prohorira
হেগেই	hegei
মহমেডানে	mohamedane
শেষকৃত্যেই	Sheshkrityei
ভিক্টিম	victim
এগারোটা	Egarota
কর্মসূত্রেই	Kormosutrei
কবচ	Koboch
বেচাল	bechal
কুমিড়া	Kumira
সঙ্গীতশিক্ষিকার	Sangeet shikkhikar
গান্ধীনগর	Gandhinagar
জ্যোতিষবাণীতে	Jyotishbanite
পাঠালো	pathalo
ম্যাড়মেড়ে	Myarmyare
ব্যাকপ্যাকিং	bagpacking
কৃষকরাই	krishokrai
মুজফ্‌ফরনগর	muzzaffarnagar
সমন	Somon
সাবাস	shabash
ফ্রানসিস্কো	Francisco
লুন্ঠিত	luntito
হিলিবিলি	Hilibili
রামজীবনপুর	ramjibanpur
২০১৯	2019
তলোয়ার	Tolowar
আলাপনবাবু	alaponbabu
ছবছরে	chhobochhore
আর্মি	Army
চিরাং	Chirang
বিকোবে	Bikobe
সিঁধুর	sidhur
দরিপা	doripa
স্পাইএর	spier
একাংশেরও	Ekangshero
জড়ত্ব	jorotto
অনাস্থার	Onasthar
ভানুমতীর	Bhanumotir
ট্যুরিস্টহয়েই	tourist hoyei
ডিস্ট্রিটো	distrito
অ্যাঙ্ক	ayank
ফেডারেশনে	federatione
খারাপই	Kharap e
রেপ্লিকেশন	Replication
স্বয়ংসেবক	Soyongshebok
স্বয়ংসেবক	soyongsebok
প়ঞ্জাবের	punjaber
জয়গৌরবে	joygourobe
গৃহূধুদের	grihodhuder
শ্রীজানার	Srijanar
সুনির্মাণ	sunirman
ফোনের	Biswajudhho
ডুরেক্সের	Durexer
২০তে	20te
চেস্টের	Chester
ধর্মশালাগুলিতে	dharmashala gulite
এটারই	etare
ধ্রুপদী	Dhrupodi
আক্রোশেরই	Akroshei
উক্তি	ukti
আইএর	I er
সবুজকলি	sobujkoli
সুরজিত্	surojit
ক্ষুধা	Khudha
গোলসংখ্যা	golsongkha
থাকো	thako
জীবনযাত্রা	Jeebonjatra
মুখ্যমন্ত্রী	mukhyomontri
মালিওয়াল	Maliwal
শিশুসুরক্ষার	Sishusurokhya
নারীনির্যাতন	Narinirjaton
জ্ঞানেন্দ্র	Gyanendra
মহিলারা	mohilara
ধীর	Dheer
পাড়া	para
সাংবাদ	songbaad
টেস্টেও	testeo
প্রতিটির	protitir
ঘুরুক	ghuruk
ধরেনি	dhoreni
হীরানগর	hIranagar
তেজস্ক্রিয়	Tejoskriyo
আদ্যক্ষর	Adyokshar
পাটানির	Patanir
প্রতিচ্ছবি	Reflection
অ্যাকাদেমি	Academy
ল্যাবরেটরিতে	laborotoryte
ফলানো	Folano
চড়িয়ে	choriye
এসসিজিতে	SCG te
স্মৃতিভ্রংশের	smritibhrongsher
সুপারহিরো	Superhero
ভিভো	vivo
অঞ্জনবাবু	anjanbabu
গঙ্গে	gonge
আবর্তন	aborton
তালিকার	talikar
ফিক্সাররা	Fixerra
এনেও	Eneo
ট্রেনগুলিতেই	traingulitei
শোনো	Shona
আলোচনার	alochonar
বোঝাবে	Bojhabe
বিনীতভাবে	binitovabe
১২৫টির	125tir
আগ্নেয়াস্ত্রে	Agneoastro
বাধ্যতামূলক—	badhyotamulok
নামানোয়	namanoy
মন্দও	Mondoo
থিন	thin
কিড	kid
দৌড়	dour
কাঁসি	Kasi
শ্রোতাকে	srotake
রেখেছিলাম	rekhechilam
পাড়ুইয়ের	Parui er
বেশকয়েকজন	beshkoyekjon
বায়ো	Bayo
স্ট্রেট	straight
শেওড়াফুলিতে	Shaorafulite
শোরগোলে	shorgole
শোরগোলে	shorgole
গৃহস্থালীর	Grihosthalir
শুল্কযুদ্ধ	shulkojuddho
কোটরের	kotorer
৭৯টি	79ti
আসফাকের	Ashfaqer
চৌডল	Choul
ভোজপুরীটা	Bhojpurita
মাড়িয়ে	maRiye
করনদিঘী	Korondighi
শিশুছাত্রীর	Shishuchhatrir
১১সেপ্টেম্বর	11september
চূর্ণ	churno
প্রতিরোধে	Protirodhe
ঘূর্ণিঝ়ডের	ghurnijhorer
ওয়েব	Web
উত্তরপাড়া	Uttarpara
চৌহদ্দিতে	Chowhodditey
ইঞ্চিতে	Inchite
মমতাই	Mamatai
টুর্নামেন্টই	turnamenti
থামবেন	Thamben
ইনস্টা	Insta
যুদ্ধে	Juddhe
প্রত্যের	protyer
গেলে	gele
ঝিমঝিমে	jhimjhime
সখীত্বের	shokhitter
অগমেন্টিন	augmentin
সুপরিচিত	Shuporichito
মশকরাও	moshkorao
নিক্কো	Nikko
বিজেপিকর্মী	BJPkormi
মধুচন্দ্রা	Madhuchondra
অবরোধকেই	oboredhkei
গানমেলা	Gaanmela
পৌছেছে	Pochhechhe
পৌঁছয়	pouchoi
অধীর	Awdhir
রক্ষক	Rakshak
রকমটাই	Rokomtai
দবি	Dobi
বুদ্ধদেবকেই	Buddhodebkei
বিলোলেন	Distributed
দুপায়ের	Dupayer
দেবগ্রাম	debgram
তারকাসমাবেশ	tarokasomabesh
দুগল	dugal
পানেসরকে	panesoroke
আরিয়ানের	Aryan'der
কনে	kone
ডেভলপমেন্ট	development
দেবীনা	debina
রক্তেও	rokteo
কিটোভা	Kitobha
অভিযুক্তেরই	Obhijukteri
বাঁহাত	bahat
মেঘদূত	Meghdut
স্টুটগার্টে	stuttgart
দর্শনকে	Dorshonke
গর্গ	gorgo
রঞ্জন	ronjon
শ্যুটিংটা	Shootingta
বন্দিমৃত্যু	bondimrittu
মোহনবাগান	Mohanbagan
কসম	kosom
২রা	2ra
স্প্যান	span
ইঞ্জিনে	engine a
আসিন	asin
মামাবাড়ির	mamabarir
যুবতীকুল	Jubotikul
খুল্লম	khullam
সসুরাল	sasurala
গঠনকে	Gothonke
৮০০০০	80000
মচ্ছি	mocchi
অথচ—	Othocho-
সমাধানেই	samadhanei
মামুদকে	Mamudke
ছোটজাত	chotojaat
খেলানোই	khelanoi
সমাজবিদ্যা	Samajvidya
উপকরণ	upokoron
সেনকেই	sen kei
সমাজবাদি	Somajbadi
আইল্যান্ডসে	ailandse
আইল্যান্ডসে	Ilandse
অনিরুদ্ধ	Oniruddho
সিইও	CEO
বন্দিই	bondie
প্রতিজ্ঞাটা	protigga tah
হিলসা	Hilsha
আরটিও	RTO
স্বদেশীদের	Swadeshider
হিমার	Himar
এক্সপায়ারি	expiry
খাটানোর	Khatanor
দুর্লভ	durlobh
মাদ্রাস	madras
যোজনা	Jojona
কমলবাবুর	komolbabur
তৃণমূলেও	Trinamuleo
খাঁড়া	khara
গতিবিধির	gotibidhir
মহানুভবতা	Mohanubhobota
আফিমমুগ্ধতার	Afimmugdhotar
কল্যানগড়	Kalyangawr
পকেটমারদের	pocketmar der
দেখাটা	dekhata
মোটর্সের	Motorser
একবাক্য	ekbakyo
যশকেই	joshkei
নর্দমাও	nordomao
ইএসডি	ESD
দত্তকের	Duttoker
সারাবছর	sharabochor
পরিদর্শনে	Poridorshone
পরিদর্শনে	poridorshone
পরশুদিন	porosudin
ফেনে	phone-e
থাকলেন	thaaklen
আঙুলই	angule
বাজুক	bajuk
৬৫০	650
কলোনির	kolonir
শীতটা	shithta
হামিদকে	hamidke
এড়িয়ে	Erie
তর্কে	torke
কোম্পানীর	kompanyr
বিলবোর্ডেও	billboardeo
নিরাপত্তীরক্ষীদের	nirapottarokhider
টুইটগুলি—	tweetguli
নিচু	nichu
কীর্তিতে	kirtite
পোস্টগুলো	postgulo
মালার	Malar
সন্দেহ	sondeho
ভাবনার	Bhabnar
জিকো	jiko
গিয়া	Giya
ভজহরি	Bhajohori
লেখক	lekhok
কিপার	Keeper
টলেনি	toleni
১১নং	11nong
আলাপনবাবুকে	Alapanbabuke
হালওয়ারা	Obhorthona
জন্মাষ্টমীকে	janmasthomi
কৃষিপ্রধান	krrishiprodhan
বনদফতরে	bondofotore
গুম্ফা	Gumpha
কেজরীবালকেও	kejriwalkeo
ছোট্টুকে	chhottuke
তাপমাত্রাতেই	taapmatratei
শিল্প	Shilpo
ভঙ্গিকে	bhongike
ঘড়ি	Ghori
রণক্ষেএের	Ronokhetrer
স্বশাসনের	Soshashoner
শুধথু	sudhthu
লুক্‌স	Looks
২২৪জন	224 jon
১৯৫৫	1995
ইন্দ্রাশিস	indrashis
বালিকাও	balikao
আঁতে	aante
জানোয়ার	Janowar
নস্টালজিক	nostalgic
সবর্নিম্ন	Shorbonimno
সংস্কৃতের	songoskriter
কাপড়	Kapor
মন্তর	montor
ছানির	chhanir
ফ্যাশান	Fashion
চৌরঙ্গিতে	chorongite
শোএর	show er
ওয়ার্কার্স	Workers
নিউবর্ন	newborn
নুসরতরা	Nusortora
জন্মদাত্রীকে	jonmodatrike
ইনডেক্সকে	indexke
ম্যাকগোয়ানের	Macgoander
সাপ্তাহিক	Saptahik
কিশোরেরা	Kishorera
অভিঘাতের	obhighater
ব্রসনানের	brosnaner
অস্টিনের	ostiner
ল্যান্ডলর্ড	landlord
দ্বিধাবিজড়িত	Didhabijorito
ঘটাননি	ghotanni
ভাতেরি	bhateri
গাইতাম	gaitam
ফুটোয়	Phutoy
ধ্যানের	Dhyaner
ম্যাকিলরয়	makilroy
ভরণপোষণ	bhoronposhon
ইউরিনের	Euriner
জয়দীপ	joydip
পরিবেশবিদদের	poribeshbidder
কুষ্ঠরোগের	kushthoroger
পাঁচজন	panchjon
ইউটা	Euta
বুধপুর	budhpur
ট্রেডমার্কের	trademarker
দ্বিস্তর	Distor
রাজংশীকে	rajbongsike
প্রাণের	Praner
কির্লোস্কার	Kirlosker
ফ্লেমিংয়ের	fleminger
মুর্তাজার	murtazar
এটি	Ati
জ্যোতি	jyoti
আবক্ষ	Abokkho
কয়েকদিনেই	koyekdinei
সার্ভিসেসের	Serviceser
সিরিসেনাও	Sirisenao
হার্ডকোর	Harcore
ওরিয়েন্ট	Orient
কুটো	Kuto
বিশ্বজিতকে	Biswajit ke
নলকূপের	nolkuper
ফুটলেও	futleo
ইন্ডিয়ান	Indian
ওবেরয়	oberoi
গাইলে	gaile
খানার	khanar
রূপলি	rUpli
খড়কুটোর	Khorkutor
সময়সূচি	shomoyshuchi
নগদে	Nogode
দুয়োরানী	Duorani
বেনাচিতি	Benachiti
কৃষণ	krishon
১৮২তম	182 tomo
জোয়েল	Joel
ইকরা	ikra
ডানহাতে	danhathe
চ্যাটগুলোই	Chatguloi
গুঁতোয়	huhuh
প্রক্রিয়ায়	Reaction
রুখতেই	rukhtei
প্রতিস্থাপণের	Protisthaponer
প্রিয়ঙ্কা	Priyanka
আকর্ষণীয়তা	Akorshoniyota
বন্দোবস্তটা	bondobostota
একসুর	ekshur
যৌনসঙ্গীকে	Jounosongike
উইকেটকিপারদের	wiketkiparder
কাদরির	kaderir
কর্তৃত্ব	kotritto
হেল	Hell
ক্ষতিয়ে	khotiye
আবেদনেই	abedonei
এমপিএসের	MPS er
জনপ্রিয়তাকে	Jonopriyotake
ঝাড়িটা	jharita
চ‌েয়ে	Cheye
ওয়ার্ডজুড়ে	Wardjure
নিন্দনীয়	nindoniyo
নারদকর্তার	narodkortara
অপঘাতে	Opoghate
বাহুল্যে	bahulyo
কমাচ্ছে	komachche
উলটে	ulte
খেলোয়াড়	kheloar
গোপালের	Gopaler
জাদেজার	Jadejar
গণপ্রহারে	Ganoprohare
পরিধি	Poridhi
সেনিয়া	seniya
ফ্যাসিজমের	Fasijomer
প্রতিপক্ষকেই	protipokkhokei
বক্সটি	Boxti
ম্যানপ্যাক্ট	Manpact
অপেক্ষাকৃত	poekkhakrito
দলুইয়ের	Dolui er
আইএমআই	IMI
মানুষীকে	manushike
মোটরসাইকেল	motorcycle
গড়লেন	Gorlen
গড়লেন	gorlen
সাম্প্রতিককালে	Samprotikkale
ধ্বংসলীলাই	Dhongshoshila-ee
চন্দ্রিমাকে	Chandrimake
মহাসভাও	Mohasobhao
কোনদিনই	konodin e
বাহু	Bahu
মৌসুমীর	Mousumir
ট্যাঙ্কারের	tankerer
টিডি	tidi
দুধকুমার	Dudhkumar
বোঝানো	Bojhaano
টুক	took
পাত্রপক্ষকেও	patropokhyokeo
আওড়ান	Aworano
নামিবিয়াকে	namibiyake
আলপনা	Alpona
উচ্চবর্ণকে	Ucchobornoke
ভাবলে	vable
মেহমান	Mehoman
হ্যাজেল	hajel
প়ড়েছে	Poreche
একদিনের	ekdiner
সামসুল	samsul
সারদা	Sarada
গরীবের	gariber
স্কাউটদের	scoutder
মার্কিনীদের	Markinider
আত্মবিলীন	Attobilin
গুণে	gune
সিদ্দিকিরা	siddiqi ra
মহাকাণ্ড	Mohakando
হেরিটেজ	Heritage
অভিনবত্বেও	obhinobotweo
যুদ্ধং	Juddhong
ছ‌েড়েছিলেন	cherechilen
ইকোনমির	Economy r
এইডস	Aeids
১৭৯৯	1799
দেড়	Der
৭০০০০৬	700006
হোমটাস্ক	Home task
ট্রি	Tree
শেষপাতে	Seshpate
পারলেন	parlen
মনোজকুমার	Manojkumar
মাসোয়ারা	mashoyara
পাল্টাচ্ছেন	paltachhen
টোটোর	totor
এটিএম	ATM
পেশমেরগা	peshmeroga
চাকুরিও	Chakurio
রাজাপুর	Rajapur
নড়ানোর	noranor
টক্কর	Tokkor
পৌঁছায়নি	pouchoeni
এডুকেশনে	Education a
টিসকা	tisca
পিতৃআজ্ঞারও	Pitriaggaro
নির্বিঘ্নেই	Nirbighnei
প্লাজাই	plaza e
রকম—	rokom
আগ়রপাড়া	Agarpara
প্রোক্টরের	proctorer
নীতিবোধ	nitibodh
পুলিসকর্মীই	poliskormie
ওয়ালশ	Walsh
উৎপাদকেরা	Producers
নাইট্‌সএ	Nightse
কথপোকথন	kothopothon
খাদিজার	Khadijar
চালিসা	Chalisha
ঢাকিরা	dhakira
রাজকর্মচারীদের	Rajkormocharider
কুমীর	Kumir
ব্যকফুটে	backfoot
সদুদ্দেশ্য	Soduddeshyo
নির্মীয়মাণ	nirmioman
মিস	miss
শিল্পকর্মই	Shilpokormoi
করিনাও	korinao
ধীরুভাই	Dhirubhai
কারাটকে	Karatke
কারোরই	karori
হালখাতা	Haalkhata
উঠিয়েছেন	Uthiechhen
মর্গানের	morganer
স্রষ্টা	srosta
করছি৷	Korchi
স্কাইপ	skype
ফক্সেস	foxes
আদিলের	Adiler
গলাচ্ছে	Golacche
গলাচ্ছে	Golachhe
সাহায্যকারী	sahajyokari
প্রায়শ্চিত্ত	Praoschitto
ম্যাজিশিয়ানের	magiciander
বিশেশ্বর	Bisheshwar
স্মরণিকা	smaranika
আপনাপন	Apnapan
শুশ্রুষা	shusrusha
নভেম্বরও	novembero
গ্রহিতার	Grohitar
নাটকগুলোর	Natokgulor
তিপ্পান্নর	tepantor
কিশোরার	kishorar
গোদারা	Godara
গোদারা	godara
প্রক্রিয়াকরণ	prokriyakoron
পঞ্চান্নয়	ponchannoy
ডাবগ্রাম	Dabgram
ভিন্‌দেশি	bhindeshi
গঙ্গাজল	Gangajol
হাঁসের	hnaaser
ভাঙড়ে	bhangore
অমরের	omorer
পলিও	Polio
চিনিয়েছিলেন	introduced
প্রাজ্ঞতার	praggotar
শান্তিকে	Shantike
শৌচাগারে	shouchagare
বডিগার্ড	bodyguard
সেবাকেন্দ্র	sebakendro
বীনার	binar
ওদিনই	oi dinei
চন্দ্রপ্রকাশ	Chandraprakash
ধর্মব্যবসায়ী	Dhormobabsaye
হাপ্পা	Happa
অকল্পনীয়	okolponiyo
বাঁক	bynak
হেয়ারের	Hairer
ফিল্মমেকারদের	Filmmaker der
অপ্টা	Opta
বিক্রমজিৎকে	Bikromjit keh
আমূল	Amul
নাইস	Nice
পদ্মেই	poddei
ষোলই	Sholoi
প্রকাশনা	prokashona
শারজা	sharja
মেহনতি	sdasdsd
বাক্যও	bakko
তড়িদাহত	Toridahoto
তড়িদাহত	Toridahoto
ক্ল্যাম্প	clamp
৮৭১	871
আমিষকে	amishke
লোপিরেভা	lopireva
সেনেগালের	senegaler
জড়তাটুকু	jorotatuku
সংকটাপন্ন	Sonkotaponno
নেমারও	Nemaro
সংক্রান্তি	songkranti
ব্যাপারও	byaparo
গুপ্তচরবৃত্তির	Guptachorbrittir
দুঃখও	Sadness
সায়নকে	Sayonke
লোভেরই	loveri
অ্যানিমিয়া	Anemia
সালাউদ্দিনও	salauddin
ভ্যারাইটিই	Variety-ee
আলোই	Light
ভা	bha
দলনেতাকে	Dolonetak
চর্মরোগ	chormorog
আফিম	afim
খড়গপুরকে	kharagpurke
এককে	ekke
নিয়মগুলো	Niyomgulo
সিস্টেম	system
কম্প্যাক্টরে	compactore
বারাহোতি	Barahoti
ডিস্ট্রিক্টে	districte
গ্রীষ্মের	Grishhyer
কেন্দ্রেও	kendreo
শান্তার	Shantar
পুঙ্গব	Pungob
মোরেস্ক	moresh
বৌমার	Boumar
আউটস্টেপে	outstepe
শাহেনসা	shahenshah
লোডিংয়ের	Loadinger
ব্রি	bri
টিমেরই	timeri
ব্লাডিয়েস্ট	bloodiest
৮জনেরই	8joner e
শরৎকাননে	shorotkanone
মেন্টর	Mentor
টিন্ট	tint
পদস্থ	podostho
ফ্লেভারের	flavourer
বজ্রবিদ্যুত্	bojrobidyut
ততোধিক	totodhik
সভানেত্রী	sobhanetri
ধরতে	Dhorte
পালানিস্বামী	Palaniswami
সুভাষদা	shuvash da
তারক	Star
সপাট	shopaat
পুকুরের	Pukurer
টমি	Tomy
আলোকচিত্রী	alokchitri
আলোকচিত্রী	alokchitro
সুরেশ	suresh
গুটিকতক	gutikotok
বাণিজ্যকেন্দ্রের	Banijyokendrer
সারনাথে	sarnath a
কাঁপাচ্ছিল	Kanpachhilo
প্রার্থনার	Prarthonar
ইদানীংকালে	idaningkale
লোকদের	Lokder
ভালবাসব	valobasb
পুলিশেরা	Policeera
হঠে	Hothe
ডোকলামের	doklamer
পট্টনায়েক	pattanayk
প্রবণতার	Probonotar
দেখছি—	Dekhchhi
রাগে	Nomoskar
সংকলনমূলক	shonkolonmulok
থাগস	thugs
দেবর্ষির	Of Mr Devarshi
রাণাঘাটে	At Ranaghat
পিস্তল	pistol
প্ল্যানগুলি	plan-guli
জুবায়ার	Jubayar
গাঢাকা	Gadhaka
বিশ্বব্যাঙ্ক	World Bank
ম্যাগনাকার্টায়	Magnakartao
লকগেট	Lockgate
ইশার	Isar
জলমগ্ন	jolomogno
শিক্ষামন্ত্রী	Shikhkhamontri
স্কিট	skit
সুমনজিৎকে	sumanjitke
জেড়ে	Jere
সেভেন	seven
শহরতলিতেও	Shohortoliteo
হ্যাম্পটন	hampton
টেন্যান্ট	Tenant
চালানোরও	chalanoro
ছুড়বেন	chudben
চার্জশিটেরর	Chargesheet er
বলরামের	Boloramer
পুলিশে	Police
এ্ররপর	erpor
লড়েছিল	Lorechilo
অতলান্ত	Deepest corner
বেস্ট	Best
পরিষেবাগুলি	Porishebaguli
গর্ভবতী	gorbhoboti
জয়দেবের	Joydeber
ম্যাগাজিনের	kobita
থাকবেনা	Thakbena
ইমেলটি	email ti
ঋ	wri
একসঙ্গেও	eksongeo
শেলি	Sheli
তারকের	taroker
থিম্যাটিক	Thematic
চিঠি	chithi
খানবিলকর	khanbilkor
অধ্যায়টিকে	Odhyaytike
মিসাইলকে	missileke
বানওয়ারিলাল	Banwarilal
চিংড়ি	chingri
গোলি	goli
প্রচার	prochar
গাইকোয়াড	gaikowad
নির্ভয়াকাণ্ড	kalke
বাঁধছে	Tied up
সৌন্দর্য্যের	Shoudorjer
স্কুলপড়ুয়াও	schoolporuao
সুযোগটুকু	sujogtuku
সারিয়ে	Sariye
দিয়েই	Diyei
নয়কো	Noyko
গহীন	gohin
মুরুব্বি	murubbi
দুর্ঘটনাও	durrghoTonao
ডিস্ট্রিবিউটরের	distributorer
বর্তেছে	Borteche
শেরপাদের	Sherpader
সিদ্দান্ত	Siddhanto
ডাকব	Dakbo
স্বপনকে	Swaponke
হোমমেড	Homemade
এফবিআই	FBI
এক্সজে	Eksje
নোটাতঙ্কে	sfasfsf
প্রতুল	Pratul
পলিশ	polish
গোষ্ঠীদ্বন্দ্বের	gosthidonder
এনেই	enei
বায়োয়ারি	bayoyari
মেরুকে	Meruke
ল্যায়লা	layla
ল্যায়লা	Laila
পারেই	parei
ফর্মটি	formti
ব্লো	Blow
বিভ্রান্তিমূলক	bibhrantimulok
আখোঁ	akho
জ্যোতিকা	jyotika
সুন্দর—	sundor
মুহূর্তটাকে	muhurtotake
মুহূর্তটাকে	muhurtotake
পাটানে	patane
একখণ্ড	ekkhondo
ত্যাগীকে	Tyagike
যেটুকু	jetuku
দীর্ঘটালবাহার	dirgho talbahar
মানছে	manche
দাঁর্জিলিংয়ে	darjilinge
পুল	Pool
কুনো	Kuno
রাধামোহনের	Radhamohoner
বিশেষণে	bisheshone
এআইসিসি	AICC
কীর্তিমান	Kirtiman
শিবগঞ্জের	shibgonjer
মাধবের	madhober
ডর্নের	dorner
দেশত্যাগী	Desh tyagi
জাদেজাকে	jadejake
সিসিপিএর	CCPer
ব্যাবসা	bebsha
শিবতলায়	shirtolay
জাদেজারা	jadejara
বিধিবদ্ধ	Bidhiboddho
মিলেনিয়ালদের	Milenialder
জড়িতরা	Joritora
আইশ্যাডোর	Eyeshadow er
সেতুটি	setuti
কাকারাও	kakarao
করলায়	korolay
এঘটনায়	eh ghotonai
ইন্সটাগ্রামে	instagramey
প্লাসএর	Plus er
রাখেনি	rakheni
উঠলও	Uthlo
উঠলও	Uthlo o
২১১জন	211jon
নবনির্মিত	nobonirmito
বাঁকে	Banke
সাথেই	Sathei
সামর্থের	samorther
প্যারিসেও	pariseo
২—	2
ভাঙামাঠ	bhangamath
নাট্যমুহূর্ত	Nattyomuhurto
ড্রামার	Drammer
দেশবিরোধীর	Deshbirodhir
টাইমেই	timei
শোরগোল	shorgol
২০০৬এ	2006 e
ফতেহ্	fateh
নিয়মবন্ধনের	niyombondhoner
রিলেটিভিটির	Relativitir
দোকান	Dokan
দোকান	dokan
অনাময়	Aunamoy
একইরকম	eirokom
উন্নয়নখাতে	Unnoyonkhate
রাফগুলো	rough gulo
ক্রেসেন্ট	cresent
আলমোদোভার	almodover
ক্রীড়াকেন্দ্রিক	Krirakendrik
বিজ্ঞানকে	bigyanke
তাহাই	tahai
কয়েনগুলি	Coinguli
অ্যাক্টিভা	Activa
চালাতাম	chalatam
আড়িপাতা	aripata
দূর্বলতা	Durbolota
রক্তপাতও	roktopato
শরিকের	soriker
লোকশিল্প	Lokoshilpo
কাছে—	kache
পড়েও	read
ইয়াজউদ্দিন	Iazuddin
অধীনতার	odhinotar
ঘোষপাড়ার	Ghoshparar
স্থানীয়	sthaniyo
শরদদের	sordder
ভিক্ষুকরা	bhikkhukra
ইউনিসেক্স	Unisex
দুস্কৃতি	dushkriti
কাটছিল	Katchilo
রটনায়	Rotonay
পুরপ্রধানকে	puroprodhanke
জেতেননি	jetenni
চলেনি	Choleni
দৌড়বীর	Dourbir
মায়েনমারের	mayanmarer
সহপঠীরাই	classmates
অনুভূতিটির	onubhutitir
হেডেনের	hedener
ইয়েলান	yelan
সুদীপবাবুর	Sudipbabur
অনশনও	onoshono
পেটেন্টের	Patent er
অর্থের	Orther
কবজা	Kobja
ধারাবাহিকভাবে	dharabahikvabe
বিজলীও	bijlio
বিজলীও	bijlio
ষষ্ঠস্থানে	soshtosthaane
বিমানভাড়া	Bimaanbhada
তাব্রিজ	Tabrij
সেক্সুয়ালিটির	Sexualityr
ভাড়া	Bhara
এতবছর	etobochhor
এতবছর	etobochhor
অসম	osomo
পূর্বপাড়া	Purbapara
মরগ্যান	morgan
ডায়ালিসিসের	Dialysiser
পাতারও	Pataro
কাবালেরোকে	Kabaleroke
সচিনকেই	sachin kei
নৌকাটিই	Noukatie
২৪৮টি	284ti
বন্দ্যোপাধ্যায়য়ের	Bandyopaddhyarer
ফ্লেভারড	flavoured
রামুকাকা	Ramukaka
চাঁদনী	Chandni
দূর—	dur
অনুভুতি	Onubhuti
হয়েছে—	Hoeche
টাকিনো	Takino
যত্রতত্র	jotrototro
ডিসেম্বরকেই	Decemberkei
ফুটলো	Futlo
কবিমানসিকতা	kobimanosikota
নিয়ে	Niye
পাল্লায়	Pallay
বনকর্তার	bonkortar
ভালমন্দ	bhalomondo
সহিসপুর	Shohishpur
বাঁচো	bancho
উঠিয়েফেলতে	Uthiyefelte
মনোরোগীকে	monorogike
বিকানিরের	Bikanirer
হাজারজন	hajarjon
পিটারকে	peter ke
ব্যাকটিরিয়া	byaktiria
গোলমাল	Golmaal
আনফোর্সড	unforced
কর্তারাই	Kortarai
কর্তারাই	kortarai
জায়গাগুলিকে	jaygagulike
সাইকেলটিতে	cycletite
যৌনকর্মীরা	Jounokormira
উদ্দীপ্ত	Udiptto
মহিষাসুরমর্দ্দিনী	Mohishashurmordini
আশার	Ashar
কুশপুতুলের	Kushputuler
পৌছাবে	Pouchabe
ভরদ্বাজও	bhorodwajo
অ্যাবর্ট	abort
ধর্ষিতার	Dhorshitar
গাঢ়ত্বে	Garottwo
তহসিলদার	Tahasildar
ঋতকে	rhitke
নদিনের	Nodiner
রাজ্যওয়াড়ি	Rajyaowari
রোতে	rote
মিসবার	misbar
১৩১	131
ব্যধিতে	Byadhite
মজুমদার	Majumdar
যোগ	jog
পরিপক্কতার	Poripokkotar
দফতরগুলিতে	Doftorgulite
পেপারব্যাক	paperback
যুক্তিকেই	Juktikei
কংগ্রেসনেতা	Congress neta
পঞ্চত্ব	Ponchottwo
সিলমোহর	Silmohor
প্রতিযোগিতাহীন	Protijogitahin
বইয়ের	Boiyer
বুলুরানি	bulurani
পার্টিগুলিকে	Partygulike
পরিবেশবিদ্‌	Paribeshbid
মুখ্যমন্ত্রীরও	mukhyomontriro
নেভি	Navy
দাবিদারদের	dabidarder
অনশন	Onoshon
স্ন্যাকস্‌	Snacks
৫৫২টি	552 ti
সাকলিন	Saklin
মেপেই	mepei
লেখিকার	lekhikar
ট্রলারটিরও	troller tir o
মন্দের	monder
কখ্খনো	Kokkhono
সুপারকাপ	Supercup
মুখচ্ছবি	mukhocchobi
দেবতার	Debotar
নাটাবাড়িতে	Natabarite
বিএমআই	BMI
মাসছয়েক	mash choyek
বেলভিউতে	Bellevue teh
বেটিং	Betting
জেরি	Jori
সংখ্যাই	sonkhai
বিক্রয়চুক্তি	Bikroychukti
গুলিটা	gulita
আঁতাঁতও	atotao
পিযূষ	Pijush
বিষোদগার	bishogar
হয়রানিকে	Hoyranike
হৃদ্‌রোগ	hridrog
মোটা	mota
কম্বিনেশন	combination
অধিনায়কত্বে—	Odhinayokotte
তাঁরও	tarao
ফগনিনিকে	fogninike
ওমাগবেমিকে	Omagbemike
উলোঝুলো	ulojhulo
যজুর্বেন্দ্র	yajubendra
কার্টুনকাণ্ড	cartoonkando
হোয়্যার	Where
১‍৬১	161
সঙ্কেতও	Sonketo
চালানোক	chalanok
আশ্বর্যের	ashorjer
উত্‍পত্তি	utpotti
বরাতএর	Boraater
আমন্ত্রন	amontron
অলোকিক	oloukik
সুদীপের	Sudiper
মন্ত্রীরই	Mantrirai
স্পোর্টসম্যানদের	sportsman der
অ‌্যাকশন	action
কুমারপাড়ায়	Kumorparay
সিগুরোসসন	Sigurosson
কমলের	komoler
রাউটারগুলি	routerguli
বুঝিয়েও	bujhiyeo
আকৃতির	Akritir
সৎকার	Sotkar
হয়েছে—টাকা	hoyeche-taka
থিম্মাইয়া	Thimmayiya
হেফাজতেও	hefajoteo
কম্মটি	kommoti
নামও	Naam'o
অববাহিকাকে	Obobahikake
ধূ	Dhu
ছাড়ানো	charano
বাণিজ্যমেলার	banijyomelar
অ্যাভয়েড	avoid
তিনি—শেন	tinisen
রোড	road
বুলে	bule
ওশানে	oshane
কেলাস	Kelash
ইশারা	ishasra
বহিরাগতরা	Bohiragotora
দক্ষিন	Dakshin
মূর্তি—	murti
আইচকে	Aichke
শালিনীর	Shalinir
কনিষ্ঠটি	konishthoti
উড	ud
দৌড়লেই	Dourolei
খরিদ্দারকে	khoriddark
হিদার	Hidar
পতাকাটির	potakatir
তারিয়েই	tariyei
পণ্ড	poshu
ব্যান্ডটা	bandta
চক্র	cokro
শফিকুল্লা	shofikulla
বাজানোয়	Bajanoy
বাজানোয়	Bajanoy
দেবীডাঙা	Debidanga
এক্সপার্ট	Expert
দিশাকে	disha keh
প়ড়াশোনা	Porashona
প়ড়াশোনা	Porashona
সারিতেও	sariteo
জুড়িয়ে	Juriye
অক্টারলোনির	Octarlonir
অ্যাডভিজরি	advisory
সাবওয়ের	Subway
অজিতকেই	Ajitkei
সীমার	seemar
কয়েকঘণ্টা	Koyekghonta
স‌োশ্যাল	social
ইচ্ছাকেই	ichhakei
মহানায়কএ	mohanayokye
গবেষকের	gobeshoker
পুরোনো	purono
মহাসভা	mohasobha
একটা	Ekta
তৃতীয়াং	Tritiyang
পড়তে	porte
নেতাজিনগরের	netajinagarer
পোজে	Pose
ছাত্রপরিষদের	Chhatraparishader
কার্বস	Carbs
দক্ষিণেও	Dokkhineo
পশুকে	poshuke
ভদ্রতা	Bhodrota
চিকিত্সকমহলও	Chikitshokmohole
দিনরাত্রি	dinratri
দশমই	Doshmoi
পরিমাণকে	porimanke
কপট	Kopot
দ্বিগুণ	Dwigun
ঝান্ডাকে	jhandake
ডিসিডিডি	DCDD
ঝ়়ড়	Jhor
বা়ড়িতে	badite
কিশোরীটি	Kishorti
ক্যাশবাক্স	cashbaksho
বিশালাকৃতি	bishalakriti
লেপার্ড	leopard
প্রতিনিধিকেও	Protinidhi-keo
১০	10
ব্যয়বহন	byaybohon
কোঅপারেটিভ	coperative
গবেষকদলের	Gabeshakdoler
লোখন্ডাওয়ালাতে	lokhandwalate
রেডার	Radar
অর্ঘদীপ	Arghadeep
জেএনইউয়ের	JNUer
বেমন্ত	bemonto
নৃশংসতার	Nirshongshotaar
বাংলাদেশি	Bangladeshi
বাগবিতণ্ডাও	bagbitonda
মু্খ্য	Mukhyo
কোনোভাবেই	Konobhabei
শব্দবন্ধনীটি	Sobdobondhonti
রাজদম্পতির	rajdompotir
সীমান্ত	simanto
চিকিত্‍সা	chikitsa
বদরক্ত	Bodrokto
পোড়ানোর	poranor
পোস্তার	Postar
নিজেরও	nijerao
টিআরটিসি	TRCC
লিবার্টিকে	libertyke
সবঅর্থেই	sob orthei
যথোপোযুক্ত	Jothopojukto
এপ্রিল	april
অস্ট্রেলীয়	Australio
শিগগির	Shiggir
কোনওরকম	Konorokom
বিষধর	bishodhor
একফালি	Ekfali
বাজারিদের	bajaridher
২লক্ষ	2 lokkho
২লক্ষ	2 Lokkho
শব্দ—	Shobdo-
একজনই	ekjonei
শ্রীলেখা	sreelekha
আনন্দজজ্ঞের	anondojogyer
রিটুইটিং	Retweeting
নাকামুরা	Nakamura
গাছটাকেই	Gachhtakei
প্রসিডেন্সির	presidencir
গোটাচারেক	gota-chaarek
প্রশংসা	proshongsha
টেনিদাকে	Teni da ke
জানজটের	janjoter
বুটি	buti
ষাটপলসা	shatpolsa
অনুতপ্ত	Onutopto
জ্ঞানেশ্বরী	gyaneshwari
হ্যাচিসন	Hutchison
আশিসকে	Ashish ke
ব্যোমকেশ	Byomkesh
শর্ত—	sorto
আলোকচিত্রের	alokchitrer
সাপেদেরও	saapedero
মুচিবাজার	Muchibazar
প্রতিভাশালী	protibhashali
নিয়া	niya
ফ্লাড	Flood
কর্পোরেটের	corporeter
কর্পোরেটের	Corporater
করেছিল	korechilo
জনবিরোধী	jonbirodhi
হরেক	horek
জমিয়েছিলেন	Jomiyechhilen
৬৩	63
বেকারির	Bakerir
মাইলো	Milo
রিহ্যাবিটেশন	Rehabilitation
পলাশি	polashi
বিনিয়োগকারীদের	biniyogkarider
ক্রিকেটারদেরই	Cricketerderi
বিষ্ঠার	bishthar
বিষধরকে	bishodhorke
গার্লফ্রেন্ডসএর	girlfirendser
সেরকম	serokom
প্রবীরবাবুরা	prabir babura
সর্বনিন্ম	sorbonimno
বিল্ডিংয়	Building
টার্গেট	target
বাঁধছেন	Baandhchhen
হেনিন	henin
বুদ্ধদেববাবুর	Buddhodebbabur
স্বরাষ্ট্রমন্ত্রীকে	Shawrashtromontri ke
সাহেবসুবোদের	sahebsuboder
মেসেজে	Mesege
সমালোচনায়	samalochanay
চরিত্রগুলিও	Charitro gulio
আদর্শে	adorshe
বিপাশার	Bipashar
শঙ্করবাবুকে	Shankarbabuke
অন্যবার	onnobar
করারা	korara
কাঠুরিয়ায়	kathuriay
এসছে	esechhe
শৈবালেন্দু	Shaibalendu
রসিকতা	rosikota
জামসেদপুরের	jamshedpurer
বা‌ংলায়	Banglay
রবীন্দ্রসঙ্গীতেও	robindrasangiteo
রবীন্দ্রসঙ্গীতেও	RobIndrosongeeteo
ট্রেনারে	Trainere
মারসারি	Marsari
মেটান	Metan
কুইন্স	quince
পান্ডিয়ান	Pandian
মহাসমাধি	mohasomadhi
উনতিরিশ	untirish
টানেলটির	taneltir
তাগড়াই	tagrai
তাগড়াই	Tagdai
পরিচারিকাও	poricharikao
দুদশক	dudoshok
বাগলে	bagle
কাঁচরাপাড়ার	kanchraparar
সত্যেন্দ্রনারায়ণ	Satyendranarayan
শ্রীকান্তদার	Srikantadar
বহুবিধ	bohubidho
হয়ওনি	houni
বাঁশবাগান	Banshbagan
নববিবাহিত	Nobobihahito
গিলেমেটে	Gilemete
সর্বে	sorbe
১৬৬	166
অ্যাডলফ	Adlof
ব্যাপ্ত	byapto
ফেস্টিভ্যালগুলিতেও	Festivalguliteo
পারফিউমের	Perfumer
স্ট্রাইকার—	striker
আকমলদের	Akmolder
তৈমুরকে	taimur keh
আর্তির	Artir
রাজনীতিটাই	rajnititai
অপব্যহার	Opobyahar
পরিবেশনাতেও	Poribeshonateo
রোমান্থন	Romanthon
অভ্যাসেও	Ovvyasheo
অন্নাকে	onnake
পুঁজিবাদ	Pujibad
তৎক্ষণাৎ	instantly
দাহ্যবস্তু	Flammable
ডাক্ট	duct
ক্লাবদের	Clubder
আত্ম	Atto
দুর্গা—	Durga
মনপসন্দ	Desired
কানভাঙানোয়	kanbhanganoy
ইম্পোজিশন	Imposition
যদি	Jodi
আইমার	Aimar
ওয়ার্ড	Ward
মন্ত্রীমশাইয়ের	Montrimoshaier
পর্যায়েই	Porjayei
পত্রপত্রিকা	potropotrika
৮টায়	8tay
নিয়েছেনু	Niyechhinu
চৈতালিকে	choitalike
ডেইলিহান্ট	dailyhunt
কেলকারের	kelkarer
বাঁধবেন	badhone
দেবল	debol
অন্যপক্ষের	onnopokkher
এ	A
এ	A
টিভি	tv
ন্যশনাল	national
টেস্টের	tester
হটলেন	hotlen
সারিবদ্ধ	sariboddho
উপবাস	upobas
গঙ্গাতীরের	gongatirer
কামড়ের	Kamorer
স্পষ্টও	Sposto
স্তরীয়	Shtorio
বন্ধুতে	Bondhute
উপায়ন্তর	upayontor
ডিকিনসন—	Dikinson
কানাডাতেই	canadatei
কুঁজওয়ালা	Kunjwala
उत्तराखण्ड	Uttarakhand
শিবকান্ত	Sivkanta
প্রতিষ্ঠানেও	Protisthaneo
ক্ষেত্রগুলিকেই	Khetrogulikei
পুণ্যলাভ	punnolabh
আস্ট্রেলিয়ায়	Australia-e
নিশানায়	Nishanay
স্ল্যামের	Slamer
কুলদীপ	kuldeep
সৌম্যজিৎকে	Soumyajit ke
ইউসারা	eusara
চাকলাদার	Chakladar
জিপিও	GPO
থেরে	there
ডানহাতটা	Danhaathta
মহাকাশেরই	mohakasheri
স্টুয়ার্টদের	stuwartsder
নিরাপত্তাকর্মীর	nirapottakormira
বোনের	boner
এডিথের	edither
কম্প্যাক্টর	Compactor
প্রতিবাদীরাও	protibadirao
মিলনেই	Milonei
ইচের	Itcher
আঁকবেন	aakben
পান	pan
জিলাপি	jilapi
নাইনটি	Ninety
কোনওটি	Konoti
দেবসেনাকে	Bazaar
তারকাঁটা	Tarkanta
উপান্তবাসী	upantobashi
বাতিস্তুতা	Batistuta
জবাই	jobai
ওয়ার্ড—	Ward
উৎসবেও	Dataset
ডাকবিভাগকে	Dakbibhag ke
দু্র্দান্ত	durdanto
দু্র্দান্ত	Dudhanto
ফ্যাসবেন্ডারও	Fyasbendaro
ওবাস	obas
রোডে	roade
বামফ্রন্টও	bamfronto
বিবর্তনে	Bibortone
আহুজার	Ahujar
আহুজার	Cholardaal
বাড়িটাকে	Baritake
বেশিরভাগের	Besirvager
অর্থসাহায্য	ortho sahajjo
আশানুরূপ	Ashanuroop
দৃষ্টান্ত	drishtanto
ভবনীপুর	bhawanipur
জয়জিত্‍	joyjit
জওয়ানেরা	jawanera
১৯১১	1911
পাণ্ডাই	pandai
বিক্রিবাটা	Bikribata
খালপাড়ে	Khaalpaare
সদর্থক	Sodorthok
ঋষিদের	rishider
বোবা	boba
পাইক	Paik
চিপ	Chip
মুভই	Movie
চাষবাসের	chasbasher
বঙ্কিমচন্দ্র	BankimChandra
৮০৯	809
সঙ্গগুণে	Songogune
গণতন্ত্রহীনতার	Gonotontrohinotar
এবরো	ebaro
রূপেই	rupei
আইনজীবীদেরও	ainjibider o
আসলে—	Actually
মক্কাকে	Mokkake
গ্রিটিংস	Grretings
স্বামীকে	Shwaamike
মেট্রোপলিটন	Metropolitan
বতর্মানে	bortomane
জনগণনার	Jonogononar
14	14
এলবিডবলুউ	LBW
সুইনহো	suinho
এতকাল	etokal
নদিয়ায়	Nodiyay
বিস্মরণের	Bismoroner
পদ্ধতিটা	poddhotita
সবিনয়নে	sobinoyone
পাবুক	pabuk
দোকানদার	dokandar
লোকরা	Lokra
রাওয়াল	rawal
সোলাপুরে	solapur a
রামবাগানে	Rambagane
অস্ট্রেলীয়রা	Ostralia
জয়ন্তর	Jayantar
রাঠোর	rathor
রাঠোর	rathore
অন্ধকারময়	Ondhokarmoy
নারীরই	Narire
মহেশই	Moheshe
ব্রিড	Breed
যাবার	Jabar
সর্বহারা	sorbohara
ট্রাবলস	troubles
পাঠ্যবই	patthyoboi
ছুটলাম	Chhutlam
পুলিশ	police
ভালুকা	Bhaluka
২০০১৩	20013
ফোর	four
ট্যাক্সিস্ট্যান্ডে	aami
হাজরা	hazra
কোহালি	Kohali
আদপেও	Adopeo
বাটি	bati
পাড়াগাঁয়ের	Paragnayer
টার্নার	tarnar
বাজেয়াপ্ত	bajeyapto
অ্যারোগ্যান্ট	Arrogant
ডবলডেকার	Double-decker
ডার্বিতে	darbite
দুর্গাকে	Durgake
নাশরি	nashri
ফুলতলা	Fultola
তিরিশেরই	Tiriseroi
কমিশকে	komiske
স্টাইলটা	Styleta
বিবর্তিত	Bibortito
বহুআলোচিত	bohualochito
আসওয়াতকে	Aaswatoke
গাদাগাদা	gadagada
প্রোগ্রামিং	programming
তনওয়ার	tonoyar
ঋদ্ধিমানকে	Ridhimanke
ভাউচারগুলি	voucherguli
থাকায়	thakai
লিঁওকে	Leonke
ভগবান	vogoban
বছরগুলির	bochhorgulir
কলসি	Kolshi
রৌদ্রকরোজ্জ্বল	roudrokorojjol
