বহন অন	Bahana ana
বহন	Bahana
গাজর	Gājara
বাহক	Bāhaka
বহন	Bahana
গাড়ী - পুল	Gāṛī - pula
গাড়ী পুল	Gāṛī pula
কার্পেটে আবরণ	Kārpēṭē ābaraṇa
carpeted	Carpeted
গালিচা	Gālicā
তক্ষণ	Takṣaṇa
সূত্রধর	Sūtradhara
দোষারোপ করা	Dōṣārōpa karā
carousel	Carousel
মদ্যপানোত্সব	Madyapānōtsaba
সংকীর্তন	Saṅkīrtana
মাংসাশী	Mānsāśī
মাংসাশী	Mānsāśī
কার্নিভালের	Kārnibhālēra
গোলাপী পাতলবর্ণ	Gōlāpī pātalabarṇa
জাগতিক	Jāgatika
হত্যাকাণ্ড	Hatyākāṇḍa
carjacking	Carjacking
carjacker	Carjacker
যত্নশীল	Yatnaśīla
ব্যঙ্গচিত্র	Byaṅgacitra
Caribou	Caribou
ক্যারিবিয়ান	Kyāribiẏāna
জাহাজী মাল	Jāhājī māla
তত্ত্বাবধায়ক	Tattbābadhāẏaka
আদর	Ādara
অসতর্কতা	Asatarkatā
অগোছালভাবে	Agōchālabhābē
অসাবধান	Asābadhāna
সাবধানতার	Sābadhānatāra
সাবধানে	Sābadhānē
সাবধান	Sābadhāna
ভাবনাহীন	Bhābanāhīna
পেশা	Pēśā
ক্যারীন	Kyārīna
যত্ন	Yatna
কার্ড	Kārḍa
হৃদ্বিজ্ঞান	Hr̥dbijñāna
অঙ্কবাচক সংখ্যা	Aṅkabācaka saṅkhyā
অঙ্কবাচক	Aṅkabācaka
পশমী গেঁজী	Paśamī gēm̐jī
কার্ডিয়াক অ্যারেস্ট	Kārḍiẏāka ayārēsṭa
কার্ডিয়াক	Kārḍiẏāka
কার্ড ক্যাটালগ	Kārḍa kyāṭālaga
পিচবোর্ড	Picabōrḍa
কার্ড	Kārḍa
দেহমাত্র	Dēhamātra
অঙ্গারক দ্বারা গ্যাস সৃষ্টি করার যঁত্র	Aṅgāraka dbārā gyāsa sr̥ṣṭi karāra yam̐tra
কারবন্ কাগজ	Kāraban kāgaja
জ্বলন্ত অঙ্গার হইতে নির্গত বিষাক্ত গ্যাসবিশেষ	Jbalanta aṅgāra ha'itē nirgata biṣākta gyāsabiśēṣa
কার্বন ডাই অক্সাইড	Kārbana ḍā'i aksā'iḍa
কারবন্ কাগজ দ্বারা গৃহীত প্রতিলিপি	Kāraban kāgaja dbārā gr̥hīta pratilipi
কার্বনেটেড	Kārbanēṭēḍa
কারবন	Kārabana
কার্বোহাইড্রেট	Kārbōhā'iḍrēṭa
ভ্রমণকারী মরূযাত্রিদল	Bhramaṇakārī marūyātridala
ক্যারেট	Kyārēṭa
আঠাল মিঠাই	Āṭhāla miṭhā'i
গাড়ী	Gāṛī
গ্রেপ্তার	Grēptāra
বন্দিকারী	Bandikārī
বন্দিদশা	Bandidaśā
বন্দী	Bandī
চিত্তাকর্ষক	Cittākarṣaka
মাত করা	Māta karā
ক্যাপশন	Kyāpaśana
অধিনায়ক	Adhināẏaka
ক্যাপসুল	Kyāpasula
উলটান	Ulaṭāna
মকর	Makara
খেয়ালখুশিমত	Khēẏālakhuśimata
খামখেয়ালী	Khāmakhēẏālī
আবদার	Ābadāra
কাপাচিনো	Kāpācinō
আত্মসমর্পণ	Ātmasamarpaṇa
আত্মসমর্পণ করা	Ātmasamarpaṇa karā
ব্যবস্থাপরিষদ্ভবন	Byabasthāpariṣadbhabana
ব্যবস্থাপরিষদ্ভবন	Byabasthāpariṣadbhabana
মৃতু্যদণ্ড	Mr̥tuyadaṇḍa
বড় হাতের অক্ষর	Baṛa hātēra akṣara
নিজ সুবিধার্থে প্রয়োগ করা	Nija subidhārthē praẏōga karā
নিজ সুবিধার্থে প্রয়োগ	Nija subidhārthē praẏōga
পুঁজিবাদী	Pum̐jibādī
পুঁজিবাদ	Pum̐jibāda
রাজধানী	Rājadhānī
কৈশিক	Kaiśika
লম্ফ	Lampha
অন্তরীপ	Antarīpa
ধারণক্ষমতা	Dhāraṇakṣamatā
সক্ষম	Sakṣama
সামর্থ্য	Sāmarthya
টুপি	Ṭupi
গভীর খাদ	Gabhīra khāda
পট	Paṭa
ক্যানভাস	Kyānabhāsa
ক্যানটোনীজ	Kyānaṭōnīja
স্বচ্ছন্দধাবন	Sbacchandadhābana
সেনানিবাসের দোকান	Sēnānibāsēra dōkāna
বদমেজাজী	Badamējājī
ফুটি	Phuṭi
নারা	Nārā
শামিয়ানা	Śāmiẏānā
canopied	Canopied
শাল্তি	Śālti
মিতব্যয়ী	Mitabyaẏī
নারা	Nārā
গোলাগুলি	Gōlāguli
কামান	Kāmāna
নরমাংসভক্ষণপ্রথা	Naramānsabhakṣaṇaprathā
রাক্ষস	Rākṣasa
Cannery	Cannery
রেডিমেড	Rēḍimēḍa
ভাং	Bhāṁ
কীট কালশিটে	Kīṭa kālaśiṭē
কীট	Kīṭa
টিন	Ṭina
কুকুরের	Kukurēra
বেত	Bēta
ক্যান্ডি বার	Kyānḍi bāra
মিছরি	Michari
অকপটতা	Akapaṭatā
পিলসুজ	Pilasuja
সন্ধ্যাকাল	Sandhyākāla
বাতি	Bāti
অকপটে	Akapaṭē
প্রার্থী	Prārthī
প্রার্থী	Prārthī
স্পষ্টবক্তা	Spaṣṭabaktā
ক্যান্সার	Kyānsāra
কর্কটরাশি	Karkaṭarāśi
বাতিল	Bātila
বাতিল	Bātila
হলদে	Haladē
খাল	Khāla
কানাডিয়ান	Kānāḍiẏāna
যা করতে পারেন	Yā karatē pārēna
বিদ্যায়তন	Bidyāẏatana
ক্যাম্পিং সাইট	Kyāmpiṁ sā'iṭa
ক্যাম্পিং	Kyāmpiṁ
ক্যাম্পের স্থান	Kyāmpēra sthāna
ক্যাম্পার	Kyāmpāra
প্রবীণ সৈনিক	Prabīṇa sainika
প্রচারাভিযান	Pracārābhiyāna
শিবির	Śibira
ছদ্মবেশ	Chadmabēśa
ক্যামেরা মানুষ	Kyāmērā mānuṣa
আলোকচিত্র-গ্রহণকারী	Ālōkacitra-grahaṇakārī
ক্যামেরা	Kyāmērā
খোদাই-করা মূতিযুক্ত মণিবিশেষ	Khōdā'i-karā mūtiyukta maṇibiśēṣa
Camellia	Camellia
উট	Uṭa
আসেন	Āsēna
camcorder	Camcorder
সহকর্মীদের মধ্যে অন্তরঙ্গতা ত্ত পরম্পরের প্রতি আস্থা	Sahakarmīdēra madhyē antaraṅgatā tta paramparēra prati āsthā
বাছুরের	Bāchurēra
ক্যালোরি	Kyālōri
ধৈর্যশীলতা	Dhairyaśīlatā
শান্তভাবে	Śāntabhābē
শান্ত	Śānta
জামুড়া	Jāmuṛā
নির্মমতা	Nirmamatā
callously	Callously
অনুভূতিহীন	Anubhūtihīna
কল ইন শো	Kala ina śō
জীবিকা	Jībikā
লিপিবিদ্যা	Lipibidyā
কল মেয়ে	Kala mēẏē
আহ্বানকারী	Āhbānakārī
কল	Kala
বস্ত্রবিশেষ	Bastrabiśēṣa
ক্রমাঙ্কন	Kramāṅkana
শক্তির পরিমাপ করা	Śaktira parimāpa karā
ধীশক্তি	Dhīśakti
বাছুর	Bāchura
ক্যালেন্ডার বছর	Kyālēnḍāra bachara
ক্যালেন্ডার	Kyālēnḍāra
পাথুরি	Pāthuri
ক্যালকুলেটর	Kyālakulēṭara
হিসাব	Hisāba
গণক	Gaṇaka
গণিত	Gaṇita
গণনা করা	Gaṇanā karā
ক্যালসিয়াম	Kyālasiẏāma
প্রমাদ	Pramāda
পিষ্টক	Piṣṭaka
চুমরান	Cumarāna
চক্রান্তে লিপ্ত	Cakrāntē lipta
সুচতুর	Sucatura
caged	Caged
খাঁচা	Khām̐cā
ক্যাফিন	Kyāphina
ক্যাফেটেরিয়া	Kyāphēṭēriẏā
ক্যাফে	Kyāphē
পদালী	Padālī
কনিষ্ঠ পুত্র	Kaniṣṭha putra
সুরের মুর্ছনা	Surēra murchanā
মৃতদেহ	Mr̥tadēha
ফণীমনসা	Phaṇīmanasā
cacti	Cacti
কক্কক্	Kakkak
ছাপ	Chāpa
ক্যাশে	Kyāśē
রন্ধনশালা	Randhanaśālā
ক্যাবল টিভি	Kyābala ṭibhi
কেব্লকার	Kēblakāra
তারের	Tārēra
মন্ত্রিসভা	Mantrisabhā
মন্ত্রিসভা	Mantrisabhā
কেবিন	Kēbina
গাড়োয়ান	Gāṛōẏāna
বাঁধাকপি	Bām̐dhākapi
সরাই	Sarā'i
ঘোড়ার গাড়ি	Ghōṛāra gāṛi
অক্ষ	Akṣa
অক্ষ	Akṣa
স্বয়ংপ্রমাণিত	Sbaẏampramāṇita
স্বত: সিদ্ধ সত্য	Sbata: Sid'dha satya
অক্ষ	Akṣa
কুঠার	Kuṭhāra
টেরা	Ṭērā
AWOL	AWOL
awoken	Awoken
awoke	Awoke
শামিয়ানা	Śāmiẏānā
জবুথবুভাব	Jabuthabubhāba
awkwardly	Awkwardly
বিশ্রী	Biśrī
অল্প সময়ের জন্য	Alpa samaẏēra jan'ya
অতিশয়	Atiśaẏa
ভয়াবহ	Bhaẏābaha
ভয়ঙ্কর	Bhaẏaṅkara
আতঙ্ককর	Ātaṅkakara
সম্ভ্রম	Sambhrama
দূরে	Dūrē
ভাসা	Bhāsā
সচেতনতা	Sacētanatā
সচেতন	Sacētana
পুরস্কার	Puraskāra
জাগরণ	Jāgaraṇa
জাগ্রত করা	Jāgrata karā
জাগ্রত	Jāgrata
প্রতীক্ষা করা	Pratīkṣā karā
হুম	Huma
স্বীকৃত	Sbīkr̥ta
স্বীকার	Sbīkāra
সত্য বলিয়া ঘোষণা করা	Satya baliẏā ghōṣaṇā karā
পরিহার	Parihāra
পরিহার্য	Parihārya
এড়াতে	Ēṛātē
আভাকাডো	Ābhākāḍō
লোভার্তভাবে	Lōbhārtabhābē
ক্ষুধিত	Kṣudhita
বিমানচালক	Bimānacālaka
বিমানচালনা	Bimānacālanā
প্রতিহত করা	Pratihata karā
অসাধ	Asādha
বিমুখ	Bimukha
গড়	Gaṛa
বীথিকা	Bīthikā
উসুল করা	Usula karā
Ave.	Ave.
ধনলোভী	Dhanalōbhī
অর্থলিপ্সা	Arthalipsā
সেনাবাহিনীর অগ্রবর্তী দল	Sēnābāhinīra agrabartī dala
ধ্বস	Dhbasa
উপলব্ধ	Upalabdha
উপস্থিতি	Upasthiti
উপকার	Upakāra
এভি	Ēbhi
সহায়ক	Sahāẏaka
শারদ	Śārada
শরৎ	Śaraṯ
autoworker	Autoworker
ময়না	Maẏanā
স্বায়ত্তশাসন	Sbāẏattaśāsana
স্বয়ংক্রিয়	Sbaẏaṅkriẏa
স্বশাসিত	Sbaśāsita
স্বয়ংচালিত	Sbaẏan̄cālita
মোটরগাড়ি	Mōṭaragāṛi
স্বয়ংক্রিয়তা	Sbaẏaṅkriẏatā
স্বয়ংক্রিয়ভাবে	Sbaẏaṅkriẏabhābē
স্বয়ংক্রিয়	Sbaẏaṅkriẏa
স্বয়ংক্রিয় পদ্ধতি প্রয়োগ করা	Sbaẏaṅkriẏa pad'dhati praẏōga karā
স্বহস্তে লেখা	Sbahastē lēkhā
স্বৈরাচারী	Sbairācārī
একনায়ক	Ēkanāẏaka
স্বৈরতন্ত্র	Sbairatantra
আত্মজীবনী	Ātmajībanī
আত্মজীবনীসংক্রান্ত	Ātmajībanīsaṅkrānta
স্বয়ং	Sbaẏaṁ
অটিস্টিক	Aṭisṭika
কৃতি	Kr̥ti
ক্ষমতাপ্রদান করা	Kṣamatāpradāna karā
অনুমোদন	Anumōdana
কর্তৃত্ব	Kartr̥tba
authoritatively	Authoritatively
প্রামাণিক	Prāmāṇika
ব্যক্তি-স্বাধীনতা অপেক্ষা কর্তৃপক্ষের বশ্যতাস্বীকারের পক্ষপাতী	Byakti-sbādhīnatā apēkṣā kartr̥pakṣēra baśyatāsbīkārēra pakṣapātī
লেখক	Lēkhaka
সত্যতা	Satyatā
প্রমাণীকরণ	Pramāṇīkaraṇa
প্রকৃত	Prakr̥ta
খাঁটি	Khām̐ṭi
অস্ট্রেলিয়ান	Asṭrēliẏāna
অস্ট্রেলিয়া	Asṭrēliẏā
কঠোরতা	Kaṭhōratā
উগ্র	Ugra
সুপ্রসন্ন	Suprasanna
পৃষ্ঠপোষকতা	Pr̥ṣṭhapōṣakatā
কর্ণ-সম্বনধীয়	Karṇa-sambanadhīẏa
দেহজ্যোতি	Dēhajyōti
মাসী	Māsī
অগাস্ট	Agāsṭa
বৃদ্ধি	Br̥d'dhi
আ	Ā
শ্রোতৃমণ্ডলীর জন্য নির্দিষ্ট স্থান	Śrōtr̥maṇḍalīra jan'ya nirdiṣṭa sthāna
নিরীক্ষক	Nirīkṣaka
শ্রুতি	Śruti
নিরীক্ষা	Nirīkṣā
শ্রবণ ত্ত দর্শন একই সঙ্গে হয় এমন	Śrabaṇa tta darśana ēka'i saṅgē haẏa ēmana
অডিও	Aḍi'ō
পাঠকবর্গ	Pāṭhakabarga
চেঁচিয়ে	Cēm̐ciẏē
শ্রাব্য	Śrābya
স্পর্ধা	Spardhā
স্পর্ধিত	Spardhita
নিলামদার	Nilāmadāra
নিলাম	Nilāma
পিঙ্গল	Piṅgala
বলতাম কিছু দিনের মধ্যেই .	Balatāma kichu dinēra madhyē'i.
attuned	Attuned
অধ্যাস	Adhyāsa
গুণ	Guṇa
বিশেষণীয়	Biśēṣaṇīẏa
চটক	Caṭaka
attractively	Attractively
আকর্ষণীয়	Ākarṣaṇīẏa
আকর্ষণ	Ākarṣaṇa
আকর্ষণ করা	Ākarṣaṇa karā
মহাব্যবহারদেশক	Mahābyabahāradēśaka
অ্যাটর্নি	Ayāṭarni
মনোভাব	Manōbhāba
বেশভূষা	Bēśabhūṣā
চিলা	Cilā
প্রত্যায়ন করা	Pratyāẏana karā
অনন্যচিত্তে	Anan'yacittē
অতন্দ্র	Atandra
মনোযোগ	Manōyōga
চেড়	Cēṛa
উপস্থিতি	Upasthiti
পরিচর্যা করা	Paricaryā karā
প্রয়াস	Praẏāsa
লব্ধি	Labdhi
অধিগম্য	Adhigamya
সাধা	Sādhā
আক্রমণকারী	Ākramaṇakārī
আক্রমণ	Ākramaṇa
ক্রোক	Krōka
সংযুক্ত	Sanyukta
সহদূত ক্ষেত্রে	Sahadūta kṣētrē
সহদূত	Sahadūta
জোড়া	Jōṛā
পাশবিকতা	Pāśabikatā
নৃশংসভাবে	Nr̥śansabhābē
নৃশংস	Nr̥śansa
প্রায়শ্চিত্ত	Prāẏaścitta
পারমাণবিক শক্তি	Pāramāṇabika śakti
পারমাণবিক বোমা	Pāramāṇabika bōmā
পারমাণবিক	Pāramāṇabika
পরমাণু	Paramāṇu
বায়ুমণ্ডলীয়	Bāẏumaṇḍalīẏa
বায়ুমণ্ডল	Bāẏumaṇḍala
এটিএম	Ēṭi'ēma
মানচিত্রাবলী	Mānacitrābalī
অতলান্তিক মহাসাগর	Atalāntika mahāsāgara
অতলান্তিক	Atalāntika
শরীরচর্চা	Śarīracarcā
খেলাধুলোর	Khēlādhulōra
ক্রীড়াবিদ	Krīṛābida
ক্রীড়াবিদ এর পাদদেশ	Krīṛābida ēra pādadēśa
নাস্তিক	Nāstika
নিরীশ্বরবাদ	Nirīśbarabāda
ate	Ate
এ	Ē
আশ্রয়	Āśraẏa
astutely	Astutely
চতুর	Catura
AstroTurf	AstroTurf
জ্যোতির্বিদ্যা	Jyōtirbidyā
জ্যোতির্বিদ্যা-সংক্রান্ত	Jyōtirbidyā-saṅkrānta
জ্যোতিষী	Jyōtiṣī
নভশ্চর	Nabhaścara
জ্যোতিষ	Jyōtiṣa
জ্যোতির্বিদ্যা-সংক্রান্ত	Jyōtirbidyā-saṅkrānta
জ্যোতিষী	Jyōtiṣī
কষাটে	Kaṣāṭē
ঘোড়ায় চড়ে	Ghōṛāẏa caṛē
বিপথে	Bipathē
স্তম্ভিত করে এমন	Stambhita karē ēmana
বিস্ময়াভিভূত করা	Bismaẏābhibhūta karā
আশ্চর্য	Āścarya
astonishingly	Astonishingly
বিস্ময়কর	Bismaẏakara
বিস্মিত	Bismita
চমত্কৃত করা	Camatkr̥ta karā
হাঁপানিসংক্রান্ত	Hām̐pānisaṅkrānta
এজমা	Ējamā
গ্রহাণু	Grahāṇu
তারকা	Tārakā
নিশ্চয়	Niścaẏa
আশ্বস্ত	Āśbasta
নিশ্চিত করা	Niścita karā
বিমা	Bimā
ধৃষ্টতা	Dhr̥ṣṭatā
অনুমান	Anumāna
Asst .	Asst.
রকমারি মাল	Rakamāri māla
হরেক	Harēka
সমিতি	Samiti
সহযোগী অধ্যাপক	Sahayōgī adhyāpaka
সহযোগী ডিগ্রী	Sahayōgī ḍigrī
সহযোগী	Sahayōgī
অ্যাসো .	Ayāsō.
Assn .	Assn.
সহকারী অধ্যাপক	Sahakārī adhyāpaka
সহায়ক	Sahāẏaka
সহায়তা	Sahāẏatā
সহায়তা	Sahāẏatā
আত্তীকরণ	Āttīkaraṇa
অঙ্গীভূত করা	Aṅgībhūta karā
নিয়োগ	Niẏōga
দায়িত্ব অর্পণ করা	Dāẏitba arpaṇa karā
asshole	Asshole
সম্পদ	Sampada
মূল্যায়ন	Mūlyāẏana
পরিমাপ করা	Parimāpa karā
দৃঢ়তাসূচনা	Dr̥ṛhatāsūcanā
জিদপূর্ণ	Jidapūrṇa
আক্রমনাত্মক	Ākramanātmaka
কথন	Kathana
জাহির করা	Jāhira karā
সম্মতি	Sam'mati
Assemblywoman	Assemblywoman
এসেম্বলির	Ēsēmbalira
অ্যাসেম্বলি লাইন	Ayāsēmbali lā'ina
সমাবেশ	Samābēśa
জুটা	Juṭā
হামলা	Hāmalā
গুপ্তহত্যা	Guptahatyā
গুপ্তহত্যা করা	Guptahatyā karā
গুপ্তঘাতক	Guptaghātaka
আততীয়	Ātatīẏa
গাধা	Gādhā
উচ্চাকাঙ্ক্ষী	Uccākāṅkṣī
এসপিরিন	Ēsapirina
উচ্চাভিলাষী হত্তয়া	Uccābhilāṣī hattaẏā
শ্বাসাঘাত	Śbāsāghāta
asphyxiation	Asphyxiation
শ্বাসরোধ করা	Śbāsarōdha karā
পিচ	Pica
কুত্সা	Kutsā
দৃষ্টিভঙ্গি	Dr̥ṣṭibhaṅgi
শতমূলী	Śatamūlī
ঘুমন্ত	Ghumanta
তির্যগ্ভাবে	Tiryagbhābē
তেরছা	Tērachā
জিজ্ঞাসা করা	Jijñāsā karā
সরাইয়া থেকে	Sarā'iẏā thēkē
একপাশে	Ēkapāśē
এশিয়ান - আমেরিকান	Ēśiẏāna - āmērikāna
এশিয়ান	Ēśiẏāna
এশিয়া	Ēśiẏā
চুরূট প্রভৃতির ছাই রাখার পাত্রবিশেষ	Curūṭa prabhr̥tira chā'i rākhāra pātrabiśēṣa
ডাঙায়	Ḍāṅāẏa
খাক	Khāka
ছাইরঙা	Chā'iraṅā
লজ্জিত	Lajjita
ছাই	Chā'i
অযৌন	Ayauna
আরোপ করা	Ārōpa karā
তপস্বী	Tapasbī
অবধারণ করা	Abadhāraṇa karā
চড়াই	Caṛā'i
ঊর্ধ্বগামী	Ūrdhbagāmī
উদয়	Udaẏa
আরোহণ করা	Ārōhaṇa karā
অ্যাসবেসটস	Ayāsabēsaṭasa
যত শীঘ্র সম্ভব	Yata śīghra sambhaba
হিসাবে	Hisābē
শিল্পকর্ম	Śilpakarma
artsy	Artsy
শিল্পকলা	Śilpakalā
শিল্পদক্ষতা	Śilpadakṣatā
সুকৌশলে	Sukauśalē
শিল্পিসুলভ	Śilpisulabha
শিল্পী	Śilpī
শিল্পী	Śilpī
কামান	Kāmāna
কৃত্রিম শ্বসন	Kr̥trima śbasana
কৃত্রিম	Kr̥trima
কৃত্রিম বুদ্ধিমত্তা	Kr̥trima bud'dhimattā
কৃত্রিম প্রজনন	Kr̥trima prajanana
কৃত্রিম	Kr̥trima
হস্তনির্মিত বস্তু	Hastanirmita bastu
স্পষ্ট উচ্চারণ	Spaṣṭa uccāraṇa
articulately	Articulately
গ্রন্থিবদ্ধ	Granthibad'dha
প্রবন্ধ	Prabandha
আর্টিচোক	Ārṭicōka
বাত	Bāta
বাত	Bāta
ধমনী	Dhamanī
ধামনিক	Dhāmanika
শিল্প	Śilpa
arsonist	Arsonist
অগ্নিসংযোগ	Agnisanyōga
সেঁকোবিষ	Sēm̐kōbiṣa
সহায়	Sahāẏa
তীর	Tīra
উদ্ধতভাবে	Ud'dhatabhābē
অহংকারী	Ahaṅkārī
দাম্ভিকতা	Dāmbhikatā
ঘটা	Ghaṭā
আগমন	Āgamana
গ্রেপ্তার	Grēptāra
বকেয়া	Bakēẏā
শ্রেণীবিন্যাস	Śrēṇībin'yāsa
বিন্যাস	Bin'yāsa
ব্যবস্থা করা	Byabasthā karā
দোষারোপ	Dōṣārōpa
দোষ দেত্তয়া	Dōṣa dēttaẏā
জাগানো	Jāgānō
arousal	Arousal
সৌরভযুক্ত	Saurabhayukta
কাছাকাছি-ঘড়ি	Kāchākāchi-ghaṛi
কাছাকাছি	Kāchākāchi
পড়েছিল	Paṛēchila
সুবাস	Subāsa
সেনা	Sēnā
অস্ত্র	Astra
বগল	Bagala
অস্ত্রাগার	Astrāgāra
সাঁজোয়াযুক্ত	Sām̐jōẏāyukta
বর্ম	Barma
যুদ্ধবিরতি	Yud'dhabirati
armhole	Armhole
খাদা-ভরা	Khādā-bharā
সশস্ত্র বাহিনী	Saśastra bāhinī
সশস্ত্র	Saśastra
আরামকেদারা	Ārāmakēdārā
armband	Armband
যুদ্ধোপকরণ	Yud'dhōpakaraṇa
সাঁজোয়া জাহাজ	Sām̐jōẏā jāhāja
হাত	Hāta
পাটীগণিত	Pāṭīgaṇita
সম্ভ্রান্ত	Sambhrānta
সম্ভ্রান্ত ব্যক্তি	Sambhrānta byakti
অভিজন	Abhijana
উদিত	Udita
উঠা	Uṭhā
মেষরাশি	Mēṣarāśi
অনুর্বর	Anurbara
গীত	Gīta
বিতর্কমূলক	Bitarkamūlaka
যুক্তি	Yukti
তর্ক করা	Tarka karā
তর্কসাপেক্ষ	Tarkasāpēkṣa
তর্কসাপেক্ষ	Tarkasāpēkṣa
না	Nā
রঙ্গভূমি	Raṅgabhūmi
এরিয়া কোড	Ēriẏā kōḍa
ক্ষেত্র	Kṣētra
হয়	Haẏa
শ্রমসাধ্য	Śramasādhya
ব্যগ্রতা	Byagratā
প্রখরভাবে	Prakharabhābē
জ্বলন্ত	Jbalanta
সুমেরুবৃত্ত	Sumērubr̥tta
উত্তর মেরু সঙক্রান্ত	Uttara mēru saṅakrānta
উত্তর মেরু সঙক্রান্ত	Uttara mēru saṅakrānta
ধনুকাকৃতি ছাদে ঢাকা পথ	Dhanukākr̥ti chādē ḍhākā patha
আর্কাইভ	Ārkā'ibha
নথিপত্র	Nathipatra
স্থাপত্য	Sthāpatya
নির্মাণকৌশল সংক্রান্ত	Nirmāṇakauśala saṅkrānta
স্থপতি	Sthapati
দ্বীপমালা	Dbīpamālā
নমিত	Namita
বিশপদের অব্যবহিত ঊর্ধ্বতন যাজকবিশেষ	Biśapadēra abyabahita ūrdhbatana yājakabiśēṣa
প্রাচীন	Prācīna
পুরাতত্ত্ব	Purātattba
প্রত্নতত্ত্ববিৎ	Pratnatattbabiṯ
প্রত্নতাত্ত্বিক	Pratnatāttbika
খিলান	Khilāna
তোরণ	Tōraṇa
চাপ	Cāpa
সালিস	Sālisa
সালিসি	Sālisi
মধ্যস্থতা করা	Madhyasthatā karā
অবাধ	Abādha
ইচ্ছামত	Icchāmata
সালিশ	Sāliśa
আবাদী	Ābādī
আরবি	Ārabi
আরব	Āraba
নালা	Nālā
জলজ	Jalaja
কুম্ভরাশি	Kumbharāśi
অ্যাকোয়ারিয়াম	Ayākōẏāriẏāma
Aquaria	Aquaria
যথাযোগ্যভাবে	Yathāyōgyabhābē
তত্পরতা পরীক্ষা	Tatparatā parīkṣā
তত্পরতা	Tatparatā
কার্যক্ষম .	Kāryakṣama.
কার্যক্ষম	Kāryakṣama
পরিচ্চদ-রক্ষক বহিরাবরণ	Pariccada-rakṣaka bahirābaraṇa
এপ্রিল ফুল ' দিবস	Ēprila phula' dibasa
এপ্রিল	Ēprila
খুবানি	Khubāni
এ	Ē
পড়তা	Paṛatā
আন্দাজ	Āndāja
আনুমানিক	Ānumānika
প্রায়.	Prāẏa.
সপ্রশংসভাবে	Sapraśansabhābē
অনুমোদন	Anumōdana
অনুমোদন করা	Anumōdana karā
অনুমোদন	Anumōdana
গ্রাস	Grāsa
উপযুক্তভাবে	Upayuktabhābē
যথাযথ	Yathāyatha
অনুমোদন	Anumōdana
অভিগমন	Abhigamana
অবগত করান	Abagata karāna
শিক্ষানবিসি	Śikṣānabisi
অভিগম্য	Abhigamya
শিক্ষানবিস	Śikṣānabisa
গ্রেফ্তার করে এমন	Grēphtāra karē ēmana
আশঙ্কা	Āśaṅkā
ধরা	Dharā
উপলব্ধি	Upalabdhi
রসিক	Rasika
উপচয়	Upacaẏa
তারিফ করা	Tāripha karā
উপলব্ধিজনক	Upalabdhijanaka
মূল্যাবধারণ করা	Mūlyābadhāraṇa karā
গুণগ্রাহিতা	Guṇagrāhitā
অংশভাগ করা	Anśabhāga karā
এপয়েন্টমেন্ট	Ēpaẏēnṭamēnṭa
কর্মে নিযুক্তি ব্যক্তি	Karmē niyukti byakti
নিযুক্ত	Niyukta
চাকরিতে বহাল করা	Cākaritē bahāla karā
প্রয়োগ করা	Praẏōga karā
ফলিত	Phalita
প্রলেপক	Pralēpaka
আবেদন	Ābēdana
আবেদক	Ābēdaka
প্রযোজ্য	Prayōjya
প্রয়োগ	Praẏōga
আজেবাজে কথা	Ājēbājē kathā
আপেল সিডার	Āpēla siḍāra
আপেল	Āpēla
সাধুবাদ	Sādhubāda
তারিফ করা	Tāripha karā
মুখরোচক	Mukharōcaka
এপেটাইজার	Ēpēṭā'ijāra
ক্ষুধা	Kṣudhā
উপাঙ্গ	Upāṅga
আন্ত্রিক রোগবিশেষ	Āntrika rōgabiśēṣa
পরিশিষ্টের	Pariśiṣṭēra
উপাঙ্গ	Upāṅga
যুক্ত করা	Yukta karā
তুষ্টি	Tuṣṭi
শান্ত করা	Śānta karā
চেহারা	Cēhārā
প্রদর্শিত	Pradarśita
মর্মস্পর্শী	Marmasparśī
আপীল	Āpīla
আবির্ভাব	Ābirbhāba
স্পষ্টত	Spaṣṭata
আপাত	Āpāta
পোশাক	Pōśāka
যন্ত্রপাতি	Yantrapāti
appallingly	Appallingly
আতঙ্কজনক	Ātaṅkajanaka
ভীত করা	Bhīta karā
অক্ষর বাদ দেত্তয়ার চিহ্ন	Akṣara bāda dēttaẏāra cihna
প্রচারের জন্য প্রেরিত ব্যক্তি-সম্বন্ধীয় ভাববাদিতুল্য	Pracārēra jan'ya prērita byakti-sambandhīẏa bhābabāditulya
দূত	Dūta
সন্ন্যাসরোগ	Sann'yāsarōga
বিবশ	Bibaśa
কৈফিয়ৎ	Kaiphiẏaṯ
ক্ষমাপ্রার্থী	Kṣamāprārthī
apologetically	Apologetically
কৈফিয়তমূলক	Kaiphiẏatamūlaka
অরাজনৈতিক	Arājanaitika
রহস্যদঘাটন	Rahasyadaghāṭana
রহস্যোদ্ঘাটন	Rahasyōdghāṭana
আত্মবিশ্বাস	Ātmabiśbāsa
জনপ্রতি	Janaprati
কামোদ্দীপক	Kāmōddīpaka
সূত্র	Sūtra
চূড়া	Cūṛā
রন্ধ্র	Randhra
এপারিটিফ	Ēpāriṭipha
উল্লুক	Ulluka
ঔদাসীন্য	Audāsīn'ya
উদাসী	Udāsī
অ্যাপার্টমেন্ট বিল্ডিং	Ayāpārṭamēnṭa bilḍiṁ
কামরা	Kāmarā
জাতিবিদ্বেষ	Jātibidbēṣa
বাদে	Bādē
পৃথক্	Pr̥thak
কোথাও	Kōthā'ō
সকল অবস্থাতেই	Sakala abasthātē'i
যে কোন সময়	Yē kōna samaẏa
কিছু	Kichu
কেউ	Kē'u
anyplace	Anyplace
আর	Āra
যে কোন উপায়ে	Yē kōna upāẏē
কেহ	Kēha
কোন	Kōna
জোরে	Jōrē
উদ্বিগ্ন	Udbigna
উদ্বেগ	Udbēga
নেহাই	Nēhā'i
মলদ্বার	Maladbāra
বিপরীতার্থক শব্দ	Biparītārthaka śabda
হরিণের সশাখ শৃঙ্গ	Hariṇēra saśākha śr̥ṅga
antitrust	Antitrust
বৈপরীত্য	Baiparītya
অসামাজিক	Asāmājika
বীজবারক	Bījabāraka
ইহুদিবিদ্বেষ	Ihudibidbēṣa
বিরোধী সেমিটিক	Birōdhī sēmiṭika
অনাদিকাল	Anādikāla
এন্টিকের	Ēnṭikēra
অপ্রচলিত	Apracalita
antiperspirant	Antiperspirant
বিদ্বেষ	Bidbēṣa
antihistamine	Antihistamine
জমাটবিরোধী পদার্থ	Jamāṭabirōdhī padārtha
প্রতিষেধক	Pratiṣēdhaka
রঙ্গভঙ্গ	Raṅgabhaṅga
ভাবাবরোহ	Bhābābarōha
anticlimactic	Anticlimactic
প্রতীক্ষা	Pratīkṣā
কহা	Kahā
অ্যান্টিবডি	Ayānṭibaḍi
জীবাণু-প্রতিরোধী	Jībāṇu-pratirōdhī
নৃবিদ্যা	Nr̥bidyā
নৃবেজ্ঞানী	Nr̥bējñānī
নৃতাত্ত্বিক	Nr̥tāttbika
সংহিতা	Sanhitā
উইঢিবি	U'iḍhibi
স্তব	Staba
এন্টেনা	Ēnṭēnā
শুঙ্গ	Śuṅga
হরিণবিশেষ	Hariṇabiśēṣa
antebellum অফ	Antebellum apha
পূর্ব	Pūrba
এন্টার্কটিকা	Ēnṭārkaṭikā
দখিনা	Dakhinā
প্রতিকূলতা করা	Pratikūlatā karā
antagonistically	Antagonistically
পরস্পরবিরোধী	Parasparabirōdhī
প্রতিদ্বন্দ্বী	Pratidbandbī
শত্রুতা	Śatrutā
অম্লনাশক	Amlanāśaka
পিপীলিকা	Pipīlikā
উত্তর মেশিন	Uttara mēśina
দায়ী	Dāẏī
উত্তর	Uttara
অন্য	An'ya
অনাগ্রহী	Anāgrahī
ক্ষুধাহীনতা	Kṣudhāhīnatā
বেনামে	Bēnāmē
নামবিহীন	Nāmabihīna
অপ্রকাশিতনামা অবস্থা	Aprakāśitanāmā abasthā
ব্যতিক্রমী	Byatikramī
লেপা	Lēpā
রদ	Rada
রদ করা	Rada karā
বার্ষিক	Bārṣika
সালিয়ানা	Sāliẏānā
বার্ষিক	Bārṣika
বিরক্তিকর	Biraktikara
উত্ত্যক্ত	Uttyakta
বিরক্তি	Birakti
বিরক্ত করা	Birakta karā
ঘোষক	Ghōṣaka
ঘোষণা	Ghōṣaṇā
ছাপানো	Chāpānō
সটীক	Saṭīka
বার্ষিকী	Bārṣikī
নাশ	Nāśa
ধ্বংস করা	Dhbansa karā
আত্মসাৎ	Ātmasāṯ
বর্ধন	Bardhana
কাহিনী	Kāhinī
গোড়ালি	Gōṛāli
শত্রুতা	Śatrutā
অ্যানিমেশন	Ayānimēśana
প্রাণবন্ত	Prāṇabanta
সজীব	Sajība
পশু	Paśu
কৌণিক	Kauṇika
ক্লেশিত	Klēśita
যন্ত্রণা	Yantraṇā
উদ্বেগ	Udbēga
ক্রুদ্ধ	Krud'dha
ক্রুদ্ধ	Krud'dha
অ্যাংলো	Ayānlō
মৎস শিকার	Maṯsa śikāra
বিলাতী	Bilātī
ছিপ দিয়ে মাছ	Chipa diẏē mācha
কোণ	Kōṇa
রাগ	Rāga
জামাল	Jāmāla
দেবদূতোপম	Dēbadūtōpama
দেবদূত	Dēbadūta
নতুনভাবে	Natunabhābē
বেদনাহীন করা	Bēdanāhīna karā
অবেদনিক প্রযোগকারী	Abēdanika prayōgakārī
অবেদনিক	Abēdanika
অ্যানেসথিসিয়াবিদ	Ayānēsathisiẏābida
অবেদন	Abēdana
রক্তহীন	Raktahīna
রক্তাল্পতা	Raktālpatā
গপ্প	Gappa
অকল্পনীয়	Akalpanīẏa
এবং	Ēbaṁ
প্রাচীন	Prācīna
হেরিং-জাতীয় ক্ষুদ্র মত্স্যবিশেষ	Hēriṁ-jātīẏa kṣudra matsyabiśēṣa
anchorwoman	Anchorwoman
Anchorman	Anchorman
নোঙ্গর	Nōṅgara
পূর্বপুরুষগণ	Pūrbapuruṣagaṇa
পৈতৃক	Paitr̥ka
পূর্বপুরুষ	Pūrbapuruṣa
শারীরস্থান	Śārīrasthāna
শারীর	Śārīra
অরাজকতা	Arājakatā
নৈরাজ্যবাদী	Nairājyabādī
বিশ্লেষণ করা	Biślēṣaṇa karā
বিশ্লেষণমূলক	Biślēṣaṇamūlaka
বিশ্লেষক	Biślēṣaka
বিশ্লেষণ	Biślēṣaṇa
বিশ্লেষণ	Biślēṣaṇa
উপমা	Upamā
অনুরূপ	Anurūpa
বেদনানাশক	Bēdanānāśaka
পায়ুসংক্রান্ত	Pāẏusaṅkrānta
এক বাক্যাংশের বর্ণসমূহের স্থানপরিবর্তনদ্বারা ভিন্ন শব্দ গঠন	Ēka bākyānśēra barṇasamūhēra sthānaparibartanadbārā bhinna śabda gaṭhana
anachronistic	Anachronistic
কালবৈষম্য	Kālabaiṣamya
একটি	Ēkaṭi
মজাদার	Majādāra
চিত্তবিনোদন পার্ক	Cittabinōdana pārka
চিত্তবিনোদন	Cittabinōdana
আমোদিত	Āmōdita
আহ্লাদিত করা	Āhlādita karā
amputee	Amputee
অঙ্গচ্ছেদ	Aṅgacchēda
নেত্তয়া	Nēttaẏā
কানায় কানায়	Kānāẏa kānāẏa
প্রশস্ত করা	Praśasta karā
পরিবর্ধক	Paribardhaka
বিকাস	Bikāsa
প্রশস্ত	Praśasta
অ্যামি্পথিয়েটার	Ayāmipathiẏēṭāra
উভচর	Ubhacara
উভচর	Ubhacara
অ্যাম্ফিটামিন	Ayāmphiṭāmina
বিদ্যুত্প্রবাহের একক	Bidyutprabāhēra ēkaka
রহমান	Rahamāna
পরিমাণ	Parimāṇa
নিরাকার	Nirākāra
কামার্ত	Kāmārta
অনৈতিক	Anaitika
মধ্যে	Madhyē
মধ্যে	Madhyē
ক্ষিপ্তবৎ	Kṣiptabaṯ
জীবাণুবিশেষ	Jībāṇubiśēṣa
রাজক্ষমা	Rājakṣamā
স্মৃতিভ্রষ্ট	Smr̥tibhraṣṭa
স্মৃতিবিলোপ	Smr̥tibilōpa
গুলি	Guli
হাইড্রোজেন ত্ত নাইট্রোজেন গ্যাসের মিলনে গ্যাসীয়	Hā'iḍrōjēna tta nā'iṭrōjēna gyāsēra milanē gyāsīẏa
গোলাবারুদ	Gōlābāruda
পথভ্রষ্ট	Pathabhraṣṭa
অন্তরে	Antarē
অভান্তরে	Abhāntarē
আপসে	Āpasē
বন্ধুত্বপূর্ণ	Bandhutbapūrṇa
অমায়িকভাবে	Amāẏikabhābē
বন্ধুভাবাপন্ন	Bandhubhābāpanna
মার্কিনিপনা	Mārkinipanā
আমেরিকান ভারতীয়	Āmērikāna bhāratīẏa
আমেরিকান স্বপ্ন	Āmērikāna sbapna
আমেরিকানা	Āmērikānā
মার্কিন	Mārkina
আমেরিকা	Āmērikā
বিনয়	Binaẏa
ক্ষতিপূরণ	Kṣatipūraṇa
সংশোধন	Sanśōdhana
সংশোধন করা	Sanśōdhana karā
এক্তিয়ারভুক্ত	Ēktiẏārabhukta
তথাস্তু	Tathāstu
উন্নয়ন	Unnaẏana
উন্নত করা	Unnata karā
ত্তৎ পাতা	Ttaṯ pātā
অ্যাম্বুলেন্স	Ayāmbulēnsa
স্বচ্ছন্দগতি	Sbacchandagati
পরস্পরবিরোধী	Parasparabirōdhī
বিরোধ	Birōdha
ambitiously	Ambitiously
উচ্চাকাঙ্ক্ষী	Uccākāṅkṣī
উচ্চাকাঙ্ক্ষা	Uccākāṅkṣā
ambiguously	Ambiguously
দ্ব্যর্থক	Dbyarthaka
অস্পষ্টতা	Aspaṣṭatā
সব্যসাচীর ন্যায় গুণবিশিষ্ট	Sabyasācīra n'yāẏa guṇabiśiṣṭa
ambiance	Ambiance
অ্যাম্বার	Ayāmbāra
রাষ্ট্রদূতসংক্রান্ত	Rāṣṭradūtasaṅkrānta
রাষ্ট্রদূত	Rāṣṭradūta
amazingly	Amazingly
আশ্চর্যজনক	Āścaryajanaka
আশ্চর্য	Āścarya
বিস্মিত	Bismita
স্তম্ভিত করা	Stambhita karā
অপেশাদারী	Apēśādārī
অপেশাদার	Apēśādāra
সমাবেশ করা	Samābēśa karā
মিশ্রণ	Miśraṇa
জোড়া লাগানো	Jōṛā lāgānō
সকাল	Sakāla
am	Am
অপরাহ্ণ	Aparāhṇa
সর্বদা	Sarbadā
প্রাক্তন ছাত্র	Prāktana chātra
প্রাক্তন ছাত্র	Prāktana chātra
alumnae	Alumnae
alumna	Alumna
অ্যালুমিনিয়াম	Ayāluminiẏāma
পরার্থপর	Parārthapara
পরার্থপরতা	Parārthaparatā
পুরাপুরি	Purāpuri
সরু	Saru
উচ্চতা	Uccatā
যদিও	Yadi'ō
অন্যথায়	An'yathāẏa
বিকল্প	Bikalpa
পরিক্রমণ	Parikramaṇa
অথবা	Athabā
একান্তর	Ēkāntara
ঝগড়াঝাঁটি	Jhagaṛājhām̐ṭi
নড়চড়	Naṛacaṛa
পরিবর্তন করা	Paribartana karā
বেদি	Bēdi
এছাড়াও	Ēchāṛā'ō
ঠিক হ্যায়	Ṭhika hyāẏa
ইতিমধ্যে	Itimadhyē
অত্যুচ্চ	Atyucca
বর্ণানুক্রমে	Barṇānukramē
বর্ণানুক্রমিক	Barṇānukramika
বর্ণমালা	Barṇamālā
সশব্দে	Saśabdē
নির্লিপ্ত	Nirlipta
পাশাপাশি	Pāśāpāśi
বরাবর	Barābara
একা	Ēkā
Aloha	Aloha
শূন্যে	Śūn'yē
ভিক্ষা	Bhikṣā
প্রায়	Prāẏa
বাদাম	Bādāma
সর্বশক্তিমান	Sarbaśaktimāna
পাঁজি	Pām̐ji
মাতৃশিক্ষায়তন	Mātr̥śikṣāẏatana
মিত্র	Mitra
ইশারা	Iśārā
মনোমুগ্ধকর	Manōmugdhakara
মোহন	Mōhana
উল্লেখ করা	Ullēkha karā
সব তারকা	Saba tārakā
সমস্ত অধিকার	Samasta adhikāra
খাদ	Khāda
ভাতা	Bhātā
সম্ভবপর	Sambhabapara
অনুমতি	Anumati
সম্পূর্ণ	Sampūrṇa
আবণ্টন	Ābaṇṭana
বাঁটা	Bām̐ṭā
বণ্টন	Baṇṭana
বরাদ্দ	Barādda
সমস্ত -সমেত	Samasta -samēta
নক্র	Nakra
স্বজাতীয়	Sbajātīẏa
জোট	Jōṭa
সরু গলি	Saru gali
হ্রাসকরণ	Hrāsakaraṇa
উপশম করা	Upaśama karā
এলার্জি	Ēlārji
বিরাগসম্পন্ন	Birāgasampanna
অপ্রস্তুতপ্রশংসা	Aprastutapraśansā
অপ্রস্তুতপ্রশংসা দ্বারা বর্ণিত	Aprastutapraśansā dbārā barṇita
আনুগত্য	Ānugatya
যেন	Yēna
কথিত	Kathita
সপক্ষে যুক্তি দেখান	Sapakṣē yukti dēkhāna
অভিযোগ	Abhiyōga
মুক্তি-সংকেত	Mukti-saṅkēta
কমান	Kamāna
বহুতরফা	Bahutaraphā
সমস্ত -আমেরিকান	Samasta -āmērikāna
আল্লাহ	Āllāha
সব	Saba
ক্ষারীয়	Kṣārīẏa
ক্ষার	Kṣāra
জীবিত	Jībita
ভরণপোষণ	Bharaṇapōṣaṇa
একইভাবে	Ēka'ibhābē
শ্রেণীবিন্যাস	Śrēṇībin'yāsa
শ্রেণীবদ্ধ করা	Śrēṇībad'dha karā
নামা	Nāmā
উন্মত্ততা	Unmattatā
স্বভাববহিভুত করা	Sbabhābabahibhuta karā
পরক	Paraka
অপরাধের অনুষ্ঠানকালে অন্যত্র থাকার অজুহাতে রেহাই পাইবার দাবি	Aparādhēra anuṣṭhānakālē an'yatra thākāra ajuhātē rēhā'i pā'ibāra dābi
উপনাম	Upanāma
অ্যালগরিদম	Ayālagaridama
বীজগাণিতিক	Bījagāṇitika
বীজগণিত	Bījagaṇita
শেত্তলাগুলি	Śēttalāguli
ত্রিপত্রোত্পাদী বৃক্ষবিশেষ	Tripatrōtpādī br̥kṣabiśēṣa
সতর্ক	Satarka
বীয়ার	Bīẏāra
alderwoman	Alderwoman
পৌরমুখ্য	Pauramukhya
তাক	Tāka
মদ্যাশক্তি	Madyāśakti
মদ্যপ	Madyapa
এলকোহল	Ēlakōhala
অ্যালবাম	Ayālabāma
ধবলরোগগ্রস্ত প্রাণী	Dhabalarōgagrasta prāṇī
তথাপি	Tathāpi
হায়রে	Hāẏarē
যে ব্যক্তি সামান্য কারণে বিপদ্সঙ্কেত ঘোষণা করে	Yē byakti sāmān'ya kāraṇē bipadsaṅkēta ghōṣaṇā karē
alarmingly	Alarmingly
ভীতিপ্রদ	Bhītiprada
অধীর	Adhīra
এলার্ম ঘড়ি	Ēlārma ghaṛi
বিপদাশঙ্কা	Bipadāśaṅkā
একটি লা মোড	Ēkaṭi lā mōḍa
একটি খাদ্যতালিকা অনুযায়ী	Ēkaṭi khādyatālikā anuyāẏī
সদৃশ	Sadr̥śa
ষদুন্মুক্তভাবে	Ṣadunmuktabhābē
করিডোর	Kariḍōra
বায়বীয়	Bāẏabīẏa
বেতার তরঙ্গ নিয়ন্ত্রণ	Bētāra taraṅga niẏantraṇa
এয়ার ট্রাফিক কন্ট্রোলার	Ēẏāra ṭrāphika kanṭrōlāra
বায়ু সময়	Bāẏu samaẏa
বায়ুরোধী	Bāẏurōdhī
airstrip	Airstrip
আকাশসীমা	Ākāśasīmā
চালিয়াতি	Cāliẏāti
বিমানযোগে আক্রমণ	Bimānayōgē ākramaṇa
বিমানবন্দর	Bimānabandara
বিমান	Bimāna
বিমানবাহিত ডাক	Bimānabāhita ḍāka
বিমান	Bimāna
এয়ারলাইন	Ēẏāralā'ina
বায়ুশূন্য	Bāẏuśūn'ya
বায়ুসেবন	Bāẏusēbana
উড়া উড়া	Uṛā uṛā
বিমানবাহিনী	Bimānabāhinī
বিমানাঙ্গন	Bimānāṅgana
airfare	Airfare
বিমানপোত বহনার্থ জাহাজ	Bimānapōta bahanārtha jāhāja
বিমান	Bimāna
এয়ার কন্ডিশনার	Ēẏāra kanḍiśanāra
বায়ু কন্ডিশনার	Bāẏu kanḍiśanāra
বাতানুকূল	Bātānukūla
বায়ুবাহিত	Bāẏubāhita
বায়ু বেস	Bāẏu bēsa
বায়ু ব্যাগ	Bāẏu byāga
বায়ু	Bāẏu
নয়	Naẏa
অকারণে	Akāraṇē
উদ্দেশ্যহীন	Uddēśyahīna
উদ্দেশ্য	Uddēśya
আময়	Āmaẏa
রোগী	Rōgī
এইডস	Ē'iḍasa
সহায়তাকারী	Sahāẏatākārī
সাহায্য	Sāhāyya
এগিয়ে	Ēgiẏē
অই	A'i
অই	A'i
কৃষি	Kr̥ṣi
কৃষিজাত	Kr̥ṣijāta
চুক্তি	Cukti
একমত	Ēkamata
প্রীতিকরভাবে	Prītikarabhābē
অমায়িক	Amāẏika
একমত	Ēkamata
নিদারূণ যন্ত্রণা	Nidārūṇa yantraṇā
মর্মান্তিকভাবে	Marmāntikabhābē
মানসিক যন্ত্রণাদায়ক	Mānasika yantraṇādāẏaka
আতুর	Ātura
পূর্বে	Pūrbē
পীড়ন করা	Pīṛana karā
অজ্ঞাবাদ	Ajñābāda
অজ্ঞানবাদী	Ajñānabādī
প্রচারক	Pracāraka
চাগাড়	Cāgāṛa
বিচলিত	Bicalita
পক্বতা	Pakbatā
উমান	Umāna
দ্রুততা	Drutatā
কর্মতত্পর	Karmatatpara
বিস্ময়ে হতবুদ্ধি	Bismaẏē hatabud'dhi
তিরস্কৃত	Tiraskr̥ta
পূর্বপক্ষ	Pūrbapakṣa
হামলাদারিতা	Hāmalādāritā
সহিংস	Sahinsa
আক্রমণমূলক	Ākramaṇamūlaka
হানা	Hānā
অধোগমন	Adhōgamana
বিরক্তিকর	Biraktikara
বাড়া	Bāṛā
বয়সের	Baẏasēra
প্রতিনিধি	Pratinidhi
বিষয়সূচি	Biṣaẏasūci
এজেন্সি	Ējēnsi
বুড়া	Buṛā
বয়স	Baẏasa
বিরুদ্ধে	Birud'dhē
আবার	Ābāra
পরে	Parē
পরে	Parē
অনুচিন্তা	Anucintā
আফটারশক	Āphaṭāraśaka
আফটারশেভ লোশন	Āphaṭāraśēbha lōśana
বৈকাল	Baikāla
ভবিষ্যৎ ফল	Bhabiṣyaṯ phala
ভবিষ্যৎ জীবন	Bhabiṣyaṯ jībana
পরিণাম	Pariṇāma
পরে	Parē
আফ্রিকান - আমেরিকান	Āphrikāna - āmērikāna
আফ্রিকান	Āphrikāna
আফ্রিকা	Āphrikā
পুনর্বার	Punarbāra
ভীত	Bhīta
সমুদ্রে	Samudrē
অপমান করা	Apamāna karā
সাশ্রয়ী মূল্যের	Sāśraẏī mūlyēra
সামর্থ্য	Sāmarthya
সমৃদ্ধিশালী	Samr̥d'dhiśālī
সমৃদ্ধি	Samr̥d'dhi
পরিতাপ	Paritāpa
হীন করা	Hīna karā
জুড়া	Juṛā
affirmatively	Affirmatively
সম্মতিসূচক এক্সন	Sam'matisūcaka ēksana
হাঁ-সূচক	Hām̐-sūcaka
কথন	Kathana
যাথাথ্র্য করা	Yāthāthrya karā
সম্বন্ধ	Sambandha
অন্তর্ভুক্তি	Antarbhukti
সম্বদ্ধ	Sambad'dha
শাখা	Śākhā
হলফনামা	Halaphanāmā
affectionately	Affectionately
অনুরক্ত	Anurakta
মমতা	Mamatā
আক্রান্ত	Ākrānta
ভান	Bhāna
অনুভূতি	Anubhūti
বিষয়	Biṣaẏa
ব্যাপার	Byāpāra
অমায়িকভাবে	Amāẏikabhābē
ভদ্র	Bhadra
দূরবর্তী স্থান	Dūrabartī sthāna
নন্দনতত্ব	Nandanatatba
aesthetically	Aesthetically
নান্দনিক	Nāndanika
মহাকাশ	Mahākāśa
এরোসল	Ērōsala
বায়ুগতিবিদ্যা	Bāẏugatibidyā
aerodynamic	Aerodynamic
এরোবিকস	Ērōbikasa
বায়ুজীবী	Bāẏujībī
বায়বীয়	Bāẏabīẏa
উকিল	Ukila
প্রচার	Pracāra
উপদেশক	Upadēśaka
উপদেষ্টা	Upadēṣṭā
পরামর্শ	Parāmarśa
যুক্তিযুক্ত	Yuktiyukta
পরামর্শ	Parāmarśa
বিজ্ঞাপন	Bijñāpana
বিজ্ঞাপনদাতার	Bijñāpanadātāra
বিজ্ঞাপন	Bijñāpana
বিজ্ঞাপিত করা	Bijñāpita karā
বিদ্বেষ	Bidbēṣa
বিরূপ	Birūpa
প্রতিকূল	Pratikūla
বিপক্ষ	Bipakṣa
ক্রিয়া-বিশেষণিক	Kriẏā-biśēṣaṇika
বিশেষণের বিশেষণ	Biśēṣaṇēra biśēṣaṇa
দু: সাহসিক	Du: Sāhasika
দু: সাহসী	Du: Sāhasī
দু: সাহসিক কাজ	Du: Sāhasika kāja
আবির্ভাব	Ābirbhāba
খ্রীষ্টের আবির্ভাব	Khrīṣṭēra ābirbhāba
সুবিধাজনক	Subidhājanaka
সুবিধা	Subidhā
অগ্রগতি	Agragati
অগ্রসর	Agrasara
আগাম	Āgāma
ব্যভিচার	Byabhicāra
ভেজাল	Bhējāla
ব্যভিচারী	Byabhicārī
প্রাপ্তবয়স্ক	Prāptabaẏaska
তোষণ	Tōṣaṇa
নিপুণভাবে	Nipuṇabhābē
নিপুণ	Nipuṇa
ভাসিতে ভাসিতে	Bhāsitē bhāsitē
বৃক্করস	Br̥kkarasa
সজ্জা	Sajjā
বিভূষিত করা	Bibhūṣita karā
পূজা করা	Pūjā karā
অর্চনা	Arcanā
আরাধ্য	Ārādhya
অবলম্বিত	Abalambita
গ্রহণ	Grahaṇa
গৃহীত	Gr̥hīta
পোষ্যপুত্র গ্রহণ করা	Pōṣyaputra grahaṇa karā
কিশোর	Kiśōra
কৈশোর	Kaiśōra
রৌদ্রপক্ব ইষ্টক	Raudrapakba iṣṭaka
অনুযোগ	Anuyōga
সতর্ক করা	Satarka karā
স্বীকার করিয়া লইয়া	Sbīkāra kariẏā la'iẏā
প্রবেশাধিকার	Prabēśādhikāra
মানা	Mānā
ভর্তি	Bharti
গ্রহণীয়	Grahaṇīẏa
আহ্্	Āh
উপাসক	Upāsaka
প্রশংসক	Praśansaka
তারিফ করা	Tāripha karā
তারিফ	Tāripha
নৌসেনাপতি	Nausēnāpati
admirably	Admirably
ধন্য	Dhan'ya
প্রশাসক	Praśāsaka
প্রশাসনিক	Praśāsanika
প্রশাসন	Praśāsana
প্রতিপালন করা	Pratipālana karā
বিজ্ঞাপন- lib	Bijñāpana- lib
যথেচ্ছ	Yathēccha
সমন্বয়	Samanbaẏa
নিয়মিত	Niẏamita
সমন্বয় করা	Samanbaẏa karā
উপরি	Upari
ন্যায়নির্ণায়ক	N'yāẏanirṇāẏaka
ন্যায়নির্ণয় করা	N'yāẏanirṇaẏa karā
বিরতি	Birati
স্থগিত রাখা	Sthagita rākhā
সংলগ্ন	Sanlagna
সংলগ্ন করা	Sanlagna karā
বিশেষণ	Biśēṣaṇa
গুণবাচক	Guṇabācaka
সন্নিহিত	Sannihita
তদর্থক	Tadarthaka
আঠালো	Āṭhālō
আনুগত্য	Ānugatya
অনুগত	Anugata
আনুগত্য	Ānugatya
মেনে চলে	Mēnē calē
পর্যাপ্তরূপে	Paryāptarūpē
পর্যাপ্ত	Paryāpta
সাদৃশ্য	Sādr̥śya
adeptly	Adeptly
সুদক্ষ	Sudakṣa
ঠিকানা	Ṭhikānā
বিশেষ উদ্দেশ্যে সংযোজনের বস্তু	Biśēṣa uddēśyē sanyōjanēra bastu
অতিরিক্ত	Atirikta
অতিরিক্ত	Atirikta
সংযোজন	Sanyōjana
আসক্তি	Āsakti
অনুরতি	Anurati
আসক্ত	Āsakta
উপসেবক	Upasēbaka
যোগ	Yōga
এডাপটার	Ēḍāpaṭāra
অভিযোজন	Abhiyōjana
অভিযোজ্য	Abhiyōjya
মানিয়ে	Māniẏē
কণ্ঠা	Kaṇṭhā
কঠোরভাবে	Kaṭhōrabhābē
হীরক	Hīraka
প্রবচন	Prabacana
এ.ডি.	Ē.Ḍi.
বিজ্ঞাপন	Bijñāpana
কঠোরভাবে	Kaṭhōrabhābē
সূক্ষ্মকোণ	Sūkṣmakōṇa
তীব্র	Tībra
চিকিত্সা-পদ্ধতি বিশেষ	Cikitsā-pad'dhati biśēṣa
সূক্ষ্ম বুদ্ধি	Sūkṣma bud'dhi
প্রকৃতপক্ষে	Prakr̥tapakṣē
বাস্তবায়ন	Bāstabāẏana
বাস্তবতা	Bāstabatā
আসল	Āsala
অভিনেত্রী	Abhinētrī
অভিনেতা	Abhinētā
কার্যকলাপ	Kāryakalāpa
কর্মী	Karmī
অ্যাক্টিভিজম	Ayākṭibhijama
সক্রিয়	Sakriẏa
অ্যাক্টিভেশন	Ayākṭibhēśana
সক্রিয় করা	Sakriẏa karā
কর্ম	Karma
অভিনয়	Abhinaẏa
আইন	Ā'ina
আইন	Ā'ina
এক্রাইলিক	Ēkrā'ilika
জুড়ে দ্য বোর্ড	Juṛē dya bōrḍa
থেকে জুড়ে	Thēkē juṛē
আড়াআড়ি	Āṛā'āṛi
অন্য শব্দের আদ্যক্ষর দ্বারা গঠিত শব্দ	An'ya śabdēra ādyakṣara dbārā gaṭhita śabda
দড়াবাজি	Daṛābāji
মত পরিবর্তন করে এমন	Mata paribartana karē ēmana
মল্ল	Malla
মেজাজ আচরণ ভাষা প্রভৃতির রুক্ষতা	Mējāja ācaraṇa bhāṣā prabhr̥tira rukṣatā
বদমেজাজি	Badamējāji
ঝাল	Jhāla
ভূসম্পত্তি	Bhūsampatti
বেকসুর খালাস	Bēkasura khālāsa
আজাদ করা	Ājāda karā
অর্জন	Arjana
অর্জন করা	Arjana karā
মৌনসন্মতি	Maunasanmati
সম্মত হত্তয়া	Sam'mata hattaẏā
পরিচিত	Paricita
জানাশোনা	Jānāśōnā
জ্ঞাপন করা	Jñāpana karā
শ্রবণশক্তি	Śrabaṇaśakti
শাব্দ	Śābda
ত্তক্ বৃক্ষের ফল	Ttak br̥kṣēra phala
ব্রণ	Braṇa
স্বীকৃতি	Sbīkr̥ti
স্বীকৃত	Sbīkr̥ta
স্বীকার করা	Sbīkāra karā
অ্যাসিড বৃষ্টি	Ayāsiḍa br̥ṣṭi
অম্লতা	Amlatā
আম্লিক	Āmlika
অ্যাসিড	Ayāsiḍa
Achy	Achy
অ্যাকিলিসের গোড়ালি	Ayākilisēra gōṛāli
Achiever	Achiever
কৃতিত্ব	Kr̥titba
অর্জন করা	Arjana karā
ব্যাথা	Byāthā
acerbic	Acerbic
টেক্কা	Ṭēkkā
অভ্যস্ত	Abhyasta
অভ্যস্ত করা	Abhyasta karā
অভিযোগের সুরে	Abhiyōgēra surē
accusing	Accusing
ফরিয়াদী	Phariẏādī
অভিযুক্ত	Abhiyukta
অভিযুক্ত করা	Abhiyukta karā
অভিযোগ	Abhiyōga
সঠিক	Saṭhika
সঠিক	Saṭhika
সঠিকতা	Saṭhikatā
আহরণ	Āharaṇa
স্তূপাকার করা	Stūpākāra karā
জমা	Jamā
নিসৃষ্ঠ	Nisr̥ṣṭha
স্বীকৃতি	Sbīkr̥ti
হিসাবরক্ষণ	Hisābarakṣaṇa
হিসাবরক্ষক	Hisābarakṣaka
দায়ী	Dāẏī
দায়িত্ব	Dāẏitba
হিসাব	Hisāba
সম্বোধন	Sambōdhana
বাদ্যযন্ত্রবিশেষ	Bādyayantrabiśēṣa
অনুযায়ী	Anuyāẏī
তদনুসারে	Tadanusārē
অনুযায়ী	Anuyāẏī
সঙ্গতি	Saṅgati
নিষ্পাদন	Niṣpādana
সম্পন্ন	Sampanna
সাধা	Sādhā
যোগদানকারী	Yōgadānakārī
সহগমন করা	Sahagamana karā
সঙ্গতবাদক	Saṅgatabādaka
সঙ্গত	Saṅgata
আবাসন	Ābāsana
বাসস্থান	Bāsasthāna
অমায়িক	Amāẏika
মিটমাট করা	Miṭamāṭa karā
প্রশংসা	Praśansā
আবহাত্তয়ায় অভ্যস্তকরণ	Ābahāttaẏāẏa abhyastakaraṇa
নূতন জলবায়ু সহ্য করিতে অভ্যস্ত করান	Nūtana jalabāẏu sahya karitē abhyasta karāna
প্রশংসিত	Praśansita
জয়ধ্বনি	Jaẏadhbani
দুর্ঘটনা - প্রবণ	Durghaṭanā - prabaṇa
ঘটনাক্রমে	Ghaṭanākramē
আপতিক	Āpatika
দুর্ঘটনা	Durghaṭanā
আনুষঙ্গিক	Ānuṣaṅgika
প্রবেশযোগ্য	Prabēśayōgya
অভিগম্যতা	Abhigamyatā
প্রবেশ	Prabēśa
গৃহীত	Gr̥hīta
স্বীকৃতি	Sbīkr̥ti
acceptably	Acceptably
গ্রহণযোগ্য	Grahaṇayōgya
গ্রাহ্যতা	Grāhyatā
স্বীকার করা	Sbīkāra karā
উচ্চারণ করা	Uccāraṇa karā
স্বরাঘাতযুক্ত	Sbarāghātayukta
স্বরাঘাত	Sbarāghāta
বেগবর্ধক ব্যক্তি	Bēgabardhaka byakti
ত্বরণ	Tbaraṇa
দ্রুততর করা	Drutatara karā
শিক্ষায়তন	Śikṣāẏatana
শিক্ষাগত দিক	Śikṣāgata dika
কেতাবি	Kētābi
এসি	Ēsi
রসাতল	Rasātala
অসম্ভব	Asambhaba
অতল	Atala
অবমাননাকর	Abamānanākara
অপব্যবহার	Apabyabahāra
প্রচুর পরিমাণে	Pracura parimāṇē
প্রচুর	Pracura
প্রাচুর্য	Prācurya
absurdly	Absurdly
অর্থহীনতা	Arthahīnatā
অযৌক্তিক	Ayauktika
বিমূর্তন	Bimūrtana
বিমূর্ত	Bimūrta
পরিহারক	Parihāraka
বিরতি	Birati
নিবৃত্তি	Nibr̥tti
বিরত থাকা	Birata thākā
শোষণ	Śōṣaṇa
বিশোষণ	Biśōṣaṇa
বিশোষক	Biśōṣaka
শোষিত	Śōṣita
নিবিষ্ট করা	Nibiṣṭa karā
মুক্তিদান করা	Muktidāna karā
একেবারে	Ēkēbārē
পরম	Parama
অন্যমনস্কতা	An'yamanaskatā
অনুপস্থিত- mindedly	Anupasthita- mindedly
গরহাজির	Garahājira
অন্যমনস্কভাবে	An'yamanaskabhābē
কর্মক্ষেত্রাদিতে অনুপসি্থত থাকার অভ্যাস	Karmakṣētrāditē anupasithata thākāra abhyāsa
অনুপস্থিত ব্যক্তি	Anupasthita byakti
অনুপস্থিত	Anupasthita
অনুপস্থিতি	Anupasthiti
পলান	Palāna
ফোড়া	Phōṛā
আকস্মিকতা	Ākasmikatā
হঠাৎ	Haṭhāṯ
আকস্মিক	Ākasmika
বিদেশে	Bidēśē
সীমাবদ্ধতা	Sīmābad'dhatā
সংক্ষেপ করা	Saṅkṣēpa karā
পাশাপাশি	Pāśāpāśi
abrasively	Abrasively
ঘষিয়া তুলিয়া ফেলিতে সক্ষম	Ghaṣiẏā tuliẏā phēlitē sakṣama
অকপট	Akapaṭa
উপরে	Uparē
ঘোরা	Ghōrā
প্রায়	Prāẏa
উড়া	Uṛā
ব্যর্থ	Byartha
গর্ভপাত	Garbhapāta
গর্ভপাত করান	Garbhapāta karāna
আদিবাসী	Ādibāsī
আদিবাসী	Ādibāsī
জঘন্য	Jaghan'ya
বিলোপ করেছে	Bilōpa karēchē
রদ	Rada
বাতিল করা	Bātila karā
জাহাজের উপরে	Jāhājēra uparē
অস্বাভাবিক	Asbābhābika
অস্বাভাবিকতা	Asbābhābikatā
অস্বাভাবিক	Asbābhābika
দক্ষতার সহিত	Dakṣatāra sahita
নীরোগ	Nīrōga
সক্ষম	Sakṣama
বহ্নিমান	Bahnimāna
শোচনীয়	Śōcanīẏa
ক্ষমতা	Kṣamatā
মানিয়া চলে এমন	Māniẏā calē ēmana
বরদাস্ত করা	Baradāsta karā
জঘন্য	Jaghan'ya
ন্যক্কার	N'yakkāra
ঘৃণাসহকারে পরিহার করা	Ghr̥ṇāsahakārē parihāra karā
ঢাকা দেত্তয়া	Ḍhākā dēttaẏā
স্খলন	Skhalana
অপহরণ	Apaharaṇa
অপহরণ করা	Apaharaṇa karā
পেটের	Pēṭēra
উদর	Udara
পদত্যাগ	Padatyāga
প্রত্যাখ্যান করা	Pratyākhyāna karā
এবিসি এর	Ēbisi ēra
অ আ ক খ	A ā ka kha
সংক্ষেপ	Saṅkṣēpa
সংক্ষিপ্ত করা	Saṅkṣipta karā
abbr .	Abbr.
মঠ	Maṭha
ক্ষীণ করা	Kṣīṇa karā
সলজ্জ	Salajja
বিসর্জন	Bisarjana
পরিত্যক্ত	Parityakta
বর্জিত করা	Barjita karā
গণনা-যন্ত্রবিশেষ	Gaṇanā-yantrabiśēṣa
পিছনে	Pichanē
উপপথ	Upapatha
বাইট	Bā'iṭa
bystander	Bystander
দ্বারা - পণ্য	Dbārā - paṇya
পার্শ্বপথ	Pārśbapatha
উপবিধি	Upabidhi
অতীত	Atīta
বিদায়	Bidāẏa
বিদায়	Bidāẏa
দ্বারা	Dbārā
buzzword	Buzzword
হর্ণ	Harṇa
বাজপাখি	Bājapākhi
গুঁজন	Gum̐jana
buyout	Buyout
ক্রেতা	Krētā
কেনা	Kēnā
গোলগাল	Gōlagāla
আলম্ব	Ālamba
বোতামের ঘর	Bōtāmēra ghara
বোতাম	Bōtāma
পাছা	Pāchā
Butterscotch	Butterscotch
ঘোল	Ghōla
প্রজাপতি	Prajāpati
butterfingers	Butterfingers
ঝুমকাজাতীয় স্বর্ণবর্ণ পুষ্পবিশেষ	Jhumakājātīẏa sbarṇabarṇa puṣpabiśēṣa
মাখন	Mākhana
Butte	Butte
গুঁতা	Gum̐tā
খানসামা	Khānasāmā
কসাইখানা	Kasā'ikhānā
কসাই	Kasā'i
কিন্তু	Kintu
busywork	Busywork
অনধিকারচর্চাকারী	Anadhikāracarcākārī
ব্যস্ত	Byasta
ছুটাছুটি	Chuṭāchuṭi
মক্কেল	Makkēla
বক্ষ	Bakṣa
বাস স্টপেজ	Bāsa sṭapēja
busing	Busing
ব্যবসাদার-নারী	Byabasādāra-nārī
ব্যবসায়ী	Byabasāẏī
কাষ্র্যকর	Kāṣryakara
বিজনেস কার্ড	Bijanēsa kārḍa
ব্যবসা প্রশাসন	Byabasā praśāsana
ব্যবসায়	Byabasāẏa
তত্পরতাসহকারে	Tatparatāsahakārē
জঙ্গলময়	Jaṅgalamaẏa
শুষ্ক দ্রব্যের পরিমাণবিশেষ	Śuṣka drabyēra parimāṇabiśēṣa
এখন ঘুমাচ্ছে	Ēkhana ghumācchē
গুল্ম	Gulma
busboy	Busboy
বাস	Bāsa
সমাহিত করা	Samāhita karā
বিস্ফোরণ	Bisphōraṇa
কোষাধ্যক্ষ	Kōṣādhyakṣa
গর্ত করা	Garta karā
ঢেকুর	Ḍhēkura
পোড়া	Pōṛā
চাকচিক্য	Cākacikya
জ্বলন্ত	Jbalanta
দহনকারী	Dahanakārī
দাহ করা	Dāha karā
মোটাসোটা	Mōṭāsōṭā
পাট-কাপড়	Pāṭa-kāpaṛa
সমাধি	Samādhi
সিঁধ কাটিয়া চুরি	Sim̐dha kāṭiẏā curi
সিঁধ কাটিয়া চুরি করা	Sim̐dha kāṭiẏā curi karā
চোরের বিপদাশঙ্কা	Cōrēra bipadāśaṅkā
সিঁধেল চোর	Sim̐dhēla cōra
Burger	Burger
আমলাতান্ত্রিক	Āmalātāntrika
আমলা	Āmalā
আমলাতন্ত্র	Āmalātantra
অফিস	Aphisa
বোঝা	Bōjhā
buoyantly	Buoyantly
প্রাণবন্ত	Prāṇabanta
প্লবতা	Plabatā
বয়া	Baẏā
পোঁদ	Pōm̐da
শশ	Śaśa
বাধা	Bādhā
পালান বিছানা	Pālāna bichānā
পালান	Pālāna
bunion	Bunion
কাঁচা লোক	Kām̐cā lōka
অকার্য	Akārya
বাঙ্গি জাম্পিং	Bāṅgi jāmpiṁ
কুঠী	Kuṭhī
পাঁজা	Pām̐jā
গুচ্ছ	Guccha
বান	Bāna
অসমান	Asamāna
বাম্পার স্টিকার	Bāmpāra sṭikāra
বাম্পার	Bāmpāra
আচমকা	Ācamakā
অকর্মা	Akarmā
আনাড়ি	Ānāṛi
Bumblebee	Bumblebee
পশ্চাদ্দেশ	Paścāddēśa
চমত্কার	Camatkāra
বাজে কথা	Bājē kathā
গবাক্ষ	Gabākṣa
বুলিশ	Buliśa
জরির ঝালর	Jarira jhālara
মানুষ ত্ত ষাঁড়ের লড়াই	Mānuṣa tta ṣām̐ṛēra laṛā'i
মানুষ ষাঁড়ের লড়াই করে	Mānuṣa ṣām̐ṛēra laṛā'i karē
মানুষ ত্ত ষাঁড়ের লড়াই	Mānuṣa tta ṣām̐ṛēra laṛā'i
বন্দুকের গুলিদ্বারা অভেদ্য	Bandukēra gulidbārā abhēdya
বুলেটিন বোর্ড	Bulēṭina bōrḍa
বুলেটিন	Bulēṭina
গুলি	Guli
ট্র্যাক্টর	Ṭryākṭara
ভয় দেখান	Bhaẏa dēkhāna
কুকুরবিশেষ	Kukurabiśēṣa
ষাঁড়	Ṣām̐ṛa
ভারী	Bhārī
বপু	Bapu
স্ফীত	Sphīta
স্ফীতি	Sphīti
কন্দজ	Kandaja
কন্দ	Kanda
বিল্ট -ইন	Bilṭa -ina
নির্মিত	Nirmita
buildup	Buildup
ভবন	Bhabana
রচয়িতা	Racaẏitā
নির্মাণ করা	Nirmāṇa karā
ভেঁপু	Bhēm̐pu
বগী	Bagī
বাগ	Bāga
ভাঁড়	Bhām̐ṛa
ঘুষা	Ghuṣā
বাফার	Bāphāra
মহিষ	Mahiṣa
মহিষচর্ম	Mahiṣacarma
বাজেট	Bājēṭa
নাড়া	Nāṛā
ভাইডি	Bhā'iḍi
স্ফুটনোন্মুখ	Sphuṭanōnmukha
বৌদ্ধ	Baud'dha
বৌদ্ধধর্ম	Baud'dhadharma
বুদ্ধ	Bud'dha
কুঁড়ি	Kum̐ṛi
bucktoothed	Bucktoothed
বক্ল	Bakla
বালতি	Bālati
হরিণ	Hariṇa
বুদ্বুদপূর্ণ	Budbudapūrṇa
বাবল গাম	Bābala gāma
বুদ্বুদ	Budbuda
B.S.	B.S.
BS	BS
পাশবিক	Pāśabika
নরপশু	Narapaśu
নৃশংসভাবে	Nr̥śansabhābē
বর্বর বা নিষ্ঠুর	Barbara bā niṣṭhura
নির্দয়তা	Nirdaẏatā
পাশবিক	Pāśabika
একপ্রকার খুদ্রে বাঁধাকপি	Ēkaprakāra khudrē bām̐dhākapi
অসভ্য	Asabhya
ব্রাশ বন্ধ	Brāśa bandha
ব্রাশ	Brāśa
ধকল	Dhakala
শ্যামাঙ্গিনী	Śyāmāṅginī
ব্রাঞ্চ	Brāñca
কালশিটে দাগ	Kālaśiṭē dāga
ব্রাউজার	Brā'ujāra
ব্রাউজ	Brā'uja
brownstone	Brownstone
কটা	Kaṭā
Brownies	Brownies
ক্ষুদ্রকায় সুশীলা পরীবিশেষ	Kṣudrakāẏa suśīlā parībiśēṣa
ক্ষুদ্রকায় সুশীলা পরীবিশেষ	Kṣudrakāẏa suśīlā parībiśēṣa
বাদামী	Bādāmī
চোখ রাঙ্গান	Cōkha rāṅgāna
ললাট	Lalāṭa
আনীত	Ānīta
ভাই - ইন আইন	Bhā'i - ina ā'ina
ভ্রাতৃভাবে	Bhrātr̥bhābē
ভাসুর	Bhāsura
ভ্রাতৃত্ব	Bhrātr̥tba
ভাই	Bhā'i
বেশ্যালয়	Bēśyālaẏa
ঝোল	Jhōla
ঝাঁটার হাতল	Jhām̐ṭāra hātala
ঝাড়ু	Jhāṛu
সহ্য করা	Sahya karā
সন্তানসন্ততি	Santānasantati
ব্রোচ	Brōca
ব্রোঞ্জ পদক	Brōñja padaka
ব্রোঞ্জ	Brōñja
বন্য ঘোড়াবিশেষ	Ban'ya ghōṛābiśēṣa
ব্রংকাইটিস	Braṅkā'iṭisa
দালালি	Dālāli
দালাল	Dālāla
ভগ্ন হৃদয়	Bhagna hr̥daẏa
ভাঙা - ডাউন	Bhāṅā - ḍā'una
ভাঙা	Bhāṅā
কপর্দকশূন্য	Kapardakaśūn'ya
প্রচণ্ড গরম দিন	Pracaṇḍa garama dina
বচসা	Bacasā
প্রাদেশিক উচ্চারণভঙ্গি	Prādēśika uccāraṇabhaṅgi
ক্ষুদ্র পুস্তিকা	Kṣudra pustikā
ব্রোকলি	Brōkali
রণপোতের একপার্শ্বস্থিত সমুদয় কামান	Raṇapōtēra ēkapārśbasthita samudaẏa kāmāna
উদারচেতা	Udāracētā
বিস্তৃতভাবে	Bistr̥tabhābē
বিস্তীর্ণ করা	Bistīrṇa karā
ঘোষক	Ghōṣaka
ব্রডকাস্ট	Braḍakāsṭa
প্রশস্ত	Praśasta
ছিদ্র করা	Chidra karā
ভঙ্গুর	Bhaṅgura
ব্রিটিশ	Briṭiśa
britches	Britches
ব্রিটেন	Briṭēna
কূর্চ	Kūrca
দ্রুত বেগে	Druta bēgē
প্রাণবন্ত	Prāṇabanta
লোনা	Lōnā
কিনারা	Kinārā
আনা	Ānā
সমুদ্র	Samudra
ধারি	Dhāri
বুদ্ধিদীপ্তভাবে	Bud'dhidīptabhābē
উজ্জ্বল	Ujjbala
প্রতিভা	Pratibhā
উজ্জ্বলতা	Ujjbalatā
উজ্জ্বলভাবে	Ujjbalabhābē
রাঙান	Rāṅāna
উজ্জ্বল	Ujjbala
সৈন্যদলবিশেষ	Sain'yadalabiśēṣa
জাঙ্গিয়া	Jāṅgiẏā
সংক্ষিপ্তভাবে	Saṅkṣiptabhābē
ব্রিফিং	Briphiṁ
ব্রিফকেস	Briphakēsa
সংক্ষিপ্ত	Saṅkṣipta
লাগাম	Lāgāma
সেতু	Sētu
নিতকনে	Nitakanē
বর	Bara
নববধূ	Nababadhū
দাম্পত্য	Dāmpatya
ইটভাটার	Iṭabhāṭāra
রাজমিস্ত্রি	Rājamistri
ইট	Iṭa
BRIC একটি ব্র্যাক	BRIC ēkaṭi bryāka
উত্কোচ গ্রহণ	Utkōca grahaṇa
ঘুষ	Ghuṣa
ভাঁটিখানা	Bhām̐ṭikhānā
শুঁড়ী	Śum̐ṛī
ফন্দি আঁটা	Phandi ām̐ṭā
সংক্ষিপ্ততা	Saṅkṣiptatā
গুরুভাই	Gurubhā'i
ঝরঝরে	Jharajharē
অনিল	Anila
প্রজনন স্থল	Prajanana sthala
প্রজনন	Prajanana
পালক	Pālaka
বংশবৃদ্ধি করা	Banśabr̥d'dhi karā
পুষ্ট	Puṣṭa
breathtakingly	Breathtakingly
উত্তেজনাপূর্ণ	Uttējanāpūrṇa
ঊর্ধ্বশ্বাসে	Ūrdhbaśbāsē
রূদ্ধশ্বাস	Rūd'dhaśbāsa
শ্বাসক্রিয়া	Śbāsakriẏā
সাময়িক বিশ্রাম	Sāmaẏika biśrāma
শ্বাস ফেলা	Śbāsa phēlā
দম	Dama
ব্রেস্টস্ট্রোক	Brēsṭasṭrōka
স্তন্যদুগ্ধ দ্বারা প্রতিপালন করা	Stan'yadugdha dbārā pratipālana karā
বুকের দুধ খাওয়ানো	Bukēra dudha khā'ōẏānō
স্তন	Stana
ঊর্মিবেগনিবারণার্থ বাঁধ	Ūrmibēganibāraṇārtha bām̐dha
ছুটি	Chuṭi
শত্রুবূহ্যভেদ	Śatrubūhyabhēda
বিপজ্জনক	Bipajjanaka
ব্রেকিং পয়েন্ট	Brēkiṁ paẏēnṭa
বিরতি -ইন	Birati -ina
ব্রেকফাস্ট	Brēkaphāsṭa
ভাঙ্গন	Bhāṅgana
ভঙ্গুর	Bhaṅgura
বিরতি	Birati
পরিবারের জীবিকার্জক	Paribārēra jībikārjaka
পানা	Pānā
breadbasket	Breadbasket
রুটি	Ruṭi
লঙ্ঘন	Laṅghana
তাম্রকার	Tāmrakāra
brazenly	Brazenly
নির্লজ্জ	Nirlajja
গাধার ডাক	Gādhāra ḍāka
পেশীবহুল	Pēśībahula
মাংসপেশী	Mānsapēśī
তোলপাড়	Tōlapāṛa
বলিহারি	Balihāri
সাহস	Sāhasa
সাহসপূর্বক	Sāhasapūrbaka
সাহসী	Sāhasī
বাহাদুরি	Bāhāduri
বাচ্চা	Bāccā
নির্লজ্জ	Nirlajja
পিতল Knuckles	Pitala Knuckles
কাঁচুলি	Kām̐culi
পিতল	Pitala
ঢেকুর	Ḍhēkura
ব্র্যান্ডি	Bryānḍi
আনকোরা	Ānakōrā
ব্র্যান্ড নাম	Bryānḍa nāma
ভাঁজা	Bhām̐jā
ব্র্যান্ড	Bryānḍa
শাখা	Śākhā
তুষ	Tuṣa
ব্রেক	Brēka
ভাপে সিদ্ধ করা	Bhāpē sid'dha karā
মাথাল	Māthāla
মগজ-ধোলাই	Magaja-dhōlā'i
মগজ-ধোলাই	Magaja-dhōlā'i
মানসিক বিপর্যয়জনিত আবেগাদির উচ্ছ্বাস	Mānasika biparyaẏajanita ābēgādira ucchbāsa
ঘিলু	Ghilu
নির্বোধ	Nirbōdha
উদ্ভাবন	Udbhābana
মস্তিষ্ক	Mastiṣka
অন্ধ ব্যক্তির লিখনাদির প্রণালী	Andha byaktira likhanādira praṇālī
বিনুনি	Binuni
দম্ভপূর্ণ	Dambhapūrṇa
জাঁক	Jām̐ka
ষৎ লোণা	Ṣaṯ lōṇā
বন্ধনী	Bandhanī
সম্বন্ধ	Sambandha
ধনুর্বন্ধনী	Dhanurbandhanī
ব্রেসলেট	Brēsalēṭa
যুগল	Yugala
ব্রা	Brā
Bozo	Bozo
বয় স্কাউট	Baẏa skā'uṭa
বয় স্কাউট	Baẏa skā'uṭa
বালকসুলভ	Bālakasulabha
বাল্যকাল	Bālyakāla
প্রেমিক	Prēmika
বয়কট	Baẏakaṭa
ছেলে	Chēlē
বক্স বসন্ত	Baksa basanta
রঙ্গালয়ে টিকিট কিনিবার ঘর	Raṅgālaẏē ṭikiṭa kinibāra ghara
ঘুসাঘুসি	Ghusāghusi
বক্সার	Baksāra
মুষ্টিযোদ্ধা	Muṣṭiyōd'dhā
Boxcar	Boxcar
বক্স	Baksa
টাই নম	Ṭā'i nama
বোলিং	Bōliṁ
বক্রপদ	Bakrapada
বাটি	Bāṭi
অন্ত্র	Antra
নম	Nama
জড়বুদ্ধি	Jaṛabud'dhi
সর্বাধুনিক ফ্যাশনের জিনিসপত্র	Sarbādhunika phyāśanēra jinisapatra
উপলক্ষ	Upalakṣa
মধ্যবিত্ত	Madhyabitta
সংরক্ষণশীল	Sanrakṣaṇaśīla
বোরবন	Bōrabana
তোড়া	Tōṛā
খয়রাত	Khaẏarāta
উদার	Udāra
কোট	Kōṭa
সীমানাহীন	Sīmānāhīna
সীমানা	Sīmānā
আবদ্ধ	Ābad'dha
Bouncy	Bouncy
ষণ্ড	Ṣaṇḍa
দম্ভ	Dambha
বীথিকা	Bīthikā
নুড়ি	Nuṛi
কেনা	Kēnā
গাছের ডাল	Gāchēra ḍāla
bottoms	Bottoms
বটম লাইন	Baṭama lā'ina
অতল	Atala
পাদ	Pāda
বোতলের গলা	Bōtalēra galā
বোতলজাত	Bōtalajāta
বোতল	Bōtala
বিরক্তিকর	Biraktikara
মাথা ঘামান	Māthā ghāmāna
উভয়	Ubhaẏa
কলঙ্কচিহ্ন	Kalaṅkacihna
উদ্ভিদ্বিদ্যা	Udbhidbidyā
উদ্ভিদ্তাত্বিক	Udbhidtātbika
উদ্ভিদ্বিদ্যাসংক্রান্ত	Udbhidbidyāsaṅkrānta
কর্তৃত্বপ্রি়	Kartr̥tbapri
bossiness	Bossiness
bossily	Bossily
মনিব	Maniba
হৃদয়	Hr̥daẏa
অধমর্ণ	Adhamarṇa
ধার করা	Dhāra karā
যে নগরে পৌরসভা আছে	Yē nagarē paurasabhā āchē
জন্ম দেত্তয়া	Janma dēttaẏā
জন্ম - আবার	Janma - ābāra
প্রকৃতিগত	Prakr̥tigata
বিরক্তিকর	Biraktikara
একঘেয়েমি	Ēkaghēẏēmi
উদাস	Udāsa
বিঁধ	Bim̐dha
সীমান্তরেখা	Sīmāntarēkhā
সীমান্ত	Sīmānta
Bop	Bop
মাতাল	Mātāla
মদ্য	Madya
লুঠ	Luṭha
একক প্রয়াস	Ēkaka praẏāsa
যে ব্যক্তি বেআইনিভাবে আমদানি-রপ্তানি করে	Yē byakti bē'ā'inibhābē āmadāni-raptāni karē
হাইবুটের পায়া	Hā'ibuṭēra pāẏā
চালাঘর	Cālāghara
শিশুদের জন্য পশমে বোনা জুতা	Śiśudēra jan'ya paśamē bōnā jutā
বুট ক্যাম্প	Buṭa kyāmpa
বুট	Buṭa
সহায়তাকারী	Sahāẏatākārī
সাহায্য	Sāhāyya
চাষাড়ে	Cāṣāṛē
চাষী	Cāṣī
boondocks	Boondocks
বর	Bara
অস্ট্রেলিয়ার আদিবাসীদের অস্ত্রবিশেষ	Asṭrēliẏāra ādibāsīdēra astrabiśēṣa
গম্ভীর গর্জন বাক্স	Gambhīra garjana bāksa
গম্ভীর গর্জন	Gambhīra garjana
গ্রন্থকীট	Granthakīṭa
বইয়ের দোকান	Ba'iẏēra dōkāna
বই	Ba'i
বুকমার্ক	Bukamārka
গ্রন্থসঙ্কলক	Granthasaṅkalaka
পুস্তিকা	Pustikā
হিসাবরক্ষণ	Hisābarakṣaṇa
হিসাবরক্ষক	Hisābarakṣaka
বুক	Buka
গ্রন্থসঙ্কলক	Granthasaṅkalaka
bookend	Bookend
বই রাখিবার আলমারি	Ba'i rākhibāra ālamāri
বই	Ba'i
বুগি	Bugi
মানসিক ফাঁদ	Mānasika phām̐da
উদো ফাঁদ	Udō phām̐da
দোষ টিউব	Dōṣa ṭi'uba
বু - বু	Bu - bu
দোষ	Dōṣa
বূ	Bū
অস্থিময়	Asthimaẏa
অধিবৃত্তি	Adhibr̥tti
শিরাবরণ	Śirābaraṇa
পাগলাটে	Pāgalāṭē
বংগো	Baṅgō
অগ্ন্যুত্সব	Agn'yutsaba
অস্থি মজ্জা	Asthi majjā
সম্পূর্ণ শুষ্ক	Sampūrṇa śuṣka
হাড়	Hāṛa
ডোর	Ḍōra
ঋণপত্র	R̥ṇapatra
সমৃদ্ধি	Samr̥d'dhi
বিশ্বস্ত	Biśbasta
আকস্মিক বিস্ময়	Ākasmika bismaẏa
বোমারু বিমান	Bōmāru bimāna
বোমাবর্ষণ	Bōmābarṣaṇa
বোমা নিষ্পত্তি	Bōmā niṣpatti
গোলাবর্ষণ	Gōlābarṣaṇa
বোমা ছুড়িয়া মারা	Bōmā chuṛiẏā mārā
বোমা	Bōmā
বল্টু	Balṭu
তাকিয়া	Tākiẏā
Bologna	Bologna
বেহায়াপনা	Bēhāẏāpanā
নির্ভয়ে	Nirbhaẏē
সাহসী	Sāhasī
ভীম	Bhīma
স্ফুটনাঙ্ক	Sphuṭanāṅka
ফুটন্ত	Phuṭanta
বয়লার	Baẏalāra
ফোঁড়া	Phōm̐ṛā
বেদে	Bēdē
বাজে	Bājē
ভয়ে চমকাইয়া ত্তঠা	Bhaẏē camakā'iẏā ttaṭhā
নিচে bogged	Nicē bogged
bogeyman	Bogeyman
অনূপ	Anūpa
bodywork	Bodywork
শরীরের ঘ্রাণ	Śarīrēra ghrāṇa
শরীরের ভাষা	Śarīrēra bhāṣā
দেহরক্ষী	Dēharakṣī
শরীরচর্চা	Śarīracarcā
শরীর	Śarīra
শারীরিক	Śārīrika
কাঁচল	Kām̐cala
দুইখানি ছোট শ্লেজ জুড়িয়া তৈয়ারী শ্লেজ	Du'ikhāni chōṭa ślēja juṛiẏā taiẏārī ślēja
বনবিড়ালবিশেষ	Banabiṛālabiśēṣa
সূতা	Sūtā
দোলক	Dōlaka
নৌকা মানুষ	Naukā mānuṣa
নৌকা	Naukā
দাম্ভিক	Dāmbhika
অহংকার করা	Ahaṅkāra karā
boardwalk	Boardwalk
boardroom	Boardroom
বোর্ডিং স্কুল	Bōrḍiṁ skula
বোর্ডিং পাস	Bōrḍiṁ pāsa
Boardinghouse	Boardinghouse
জাহাজের যাত্রী	Jāhājēra yātrī
বোর্ড	Bōrḍa
বন্য শূকর	Ban'ya śūkara
অজগর সংকোচকারী	Ajagara saṅkōcakārī
অজগর	Ajagara
B.O.	B.O.
Blvd.	Blvd.
blusher	Blusher
বক্তিমাভা	Baktimābhā
বলে ফেলা	Balē phēlā
blurry	Blurry
ঝাপসা	Jhāpasā
গ্রন্থ-সম্বন্ধে প্রকাশকের প্রচারলিপি	Grantha-sambandhē prakāśakēra pracāralipi
দাগ	Dāga
bluntness	Bluntness
স্পষ্টভাবে	Spaṣṭabhābē
ভোঁতা	Bhōm̐tā
ভুল বোঝা	Bhula bōjhā
নীলাভ	Nīlābha
ধাপ্পাবাজি	Dhāppābāji
ব্লুজ	Bluja
প্রতিচিত্র	Praticitra
নীল আইন	Nīla ā'ina
নীল জিন্স	Nīla jinsa
নীলকণ্ঠ	Nīlakaṇṭha
ব্লুগ্রাস	Blugrāsa
নীল বাবু	Nīla bābu
নীল চিপ	Nīla cipa
নীল পনির	Nīla panira
আভিজাত্য	Ābhijātya
Bluebird	Bluebird
ব্লুবেরি	Blubēri
নীল অপরাজিতা	Nīla aparājitā
নীল	Nīla
মুগুর	Mugura
অশ্রুমোচন	Aśrumōcana
বিস্ফোরণ	Bisphōraṇa
পাইন-কাঠি	Pā'ina-kāṭhi
blowout	Blowout
প্রস্ফুটিত	Prasphuṭita
আকস্মিক শুষ্ক	Ākasmika śuṣka
ঘা	Ghā
ব্লাউজ	Blā'uja
একখণ্ড কালি-শোষক কাগজ	Ēkakhaṇḍa kāli-śōṣaka kāgaja
রঙ কালি প্রভৃতির দাগযুক্ত	Raṅa kāli prabhr̥tira dāgayukta
ফুস্কুড়ি	Phuskuṛi
ফোঁটা	Phōm̐ṭā
পুষ্প	Puṣpa
মুখ ফসকানি	Mukha phasakāni
পুষ্প	Puṣpa
রক্তাক্ত	Raktākta
রক্তবাহ	Raktabāha
রক্তের গ্রুপ	Raktēra grupa
রক্তপিপাসু	Raktapipāsu
স্রোতের	Srōtēra
রক্তমাখা	Raktamākhā
bloodstain	Bloodstain
রক্তরাঙা	Raktarāṅā
রক্তক্ষয়	Raktakṣaẏa
রক্তচাপ	Raktacāpa
রক্তপাতহীন	Raktapātahīna
গোয়েন্দা	Gōẏēndā
রক্ত দাতা	Rakta dātā
রক্তগঙ্গা	Raktagaṅgā
রক্ত	Rakta
স্বর্ণকেশী	Sbarṇakēśī
ব্লক চিঠি	Blaka ciṭhi
নিরেট	Nirēṭa
ব্লকবাস্টার	Blakabāsṭāra
প্রতিবন্ধকতা	Pratibandhakatā
অবরোধ	Abarōdha
বাধা	Bādhā
সংযোজন	Sanyōjana
ফোঁটা	Phōm̐ṭā
স্ফীত	Sphīta
প্রবল তুষারঝড়	Prabala tuṣārajhaṛa
বিমানাক্রমণ	Bimānākramaṇa
blithely	Blithely
আমুদে	Āmudē
blistering	Blistering
ফোস্কা	Phōskā
blissfully	Blissfully
সুখী	Sukhī
সুখ	Sukha
blip	Blip
নাচা	Nācā
অনাবিষ্কৃত ক্ষেত্র	Anābiṣkr̥ta kṣētra
অন্ধত্ব	Andhatba
অন্ধভাবে	Andhabhābē
বেপরোয়াভাবে	Bēparōẏābhābē
অন্ধ তারিখ	Andha tārikha
অন্ধ	Andha
Blimp	Blimp
ক্ষয়রোগাক্রান্ত করা	Kṣaẏarōgākrānta karā
blew	Blew
বর	Bara
সুখী	Sukhī
আশীর্বাদ করা	Āśīrbāda karā
মিশ্রণকারী	Miśraṇakārī
মিশ্রণ	Miśraṇa
Blemished	Blemished
কলঙ্ক	Kalaṅka
শোষিত	Śōṣita
রক্ত ঝরা	Rakta jharā
খুবই খারাপ লাগছিল	Khuba'i khārāpa lāgachila
অনির্দিষ্ট	Anirdiṣṭa
blearily	Blearily
নগ্নতা	Nagnatā
bleakly	Bleakly
নিরানন্দ	Nirānanda
bleachers	Bleachers
ব্লিচ	Blica
খেলোয়াড়ের রঙীন জামা	Khēlōẏāṛēra raṅīna jāmā
আলোকচ্ছটা	Ālōkacchaṭā
blatantly	Blatantly
স্থূল	Sthūla
BlastOff	BlastOff
মারুত-চুল্লী	Māruta-cullī
ঝঁঝা	Jham̐jhā
ধর্মনিন্দা	Dharmanindā
ধর্মহীন	Dharmahīna
অপমান করা	Apamāna karā
আর আমোদ-প্রমোদ চাহে না এমন	Āra āmōda-pramōda cāhē nā ēmana
তূর্যনিনাদ	Tūryanināda
blankness	Blankness
অসহায়ভাবে	Asahāẏabhābē
কম্বল	Kambala
নিরঙ্ক চেক	Niraṅka cēka
ফাঁকা	Phām̐kā
সবিনয়ে	Sabinaẏē
স্নিগ্ধ	Snigdha
সাদা করা	Sādā karā
অনিন্দনীয়	Anindanīẏa
দোষ	Dōṣa
বাজে কথা	Bājē kathā
ফলক	Phalaka
থলি	Thali
Blacktop	Blacktop
কামার	Kāmāra
নিষ্প্রদীপ	Niṣpradīpa
আঁধার	Ām̐dhāra
অপপণন	Apapaṇana
যে ব্যক্তি ব্ল্যাকমেল করে	Yē byakti blyākamēla karē
ব্ল্যাকমেল	Blyākamēla
তন্ত্রমন্ত্র	Tantramantra
নিষিদ্ধ জিনিসের তালিকা	Niṣid'dha jinisēra tālikā
Blackjack	Blackjack
অন্ধকূপ	Andhakūpa
কাল আঁচিল	Kāla ām̐cila
চোখের কালি	Cōkhēra kāli
দুর্নাম করা	Durnāma karā
বিদ্যালয়ে লিপির জন্য তক্তা	Bidyālaẏē lipira jan'ya taktā
কোকিলজাতীয় পক্ষী	Kōkilajātīẏa pakṣī
কালজামজাতীয় ফল	Kālajāmajātīẏa phala
কালো বেল্ট	Kālō bēlṭa
কালো	Kālō
কালো	Kālō
blabbermouth	Blabbermouth
বাচালতা	Bācālatā
উদ্ভট	Udbhaṭa
দ্বিসাপ্তাহিক	Dbisāptāhika
তিক্ততা	Tiktatā
তিক্ততার	Tiktatāra
তিক্ত	Tikta
দংশিত	Danśita
ব্যঙ্গাত্মক	Byaṅgātmaka
কামড়	Kāmaṛa
বিদ্বেষপরায়ণ	Bidbēṣaparāẏaṇa
দুশ্চরিত্রা	Duścaritrā
কিছুক্ষণ	Kichukṣaṇa
বাইসন	Bā'isana
বিশপ	Biśapa
উভলিঙ্গ	Ubhaliṅga
দ্বিখণ্ডন	Dbikhaṇḍana
দ্বিখণ্ডিত করা	Dbikhaṇḍita karā
বিসকুট	Bisakuṭa
জন্মের হার	Janmēra hāra
জন্মস্থান	Janmasthāna
জড়ুল	Jaṛula
জন্মদিন	Janmadina
জন্ম তারিখ	Janma tārikha
জন্ম নিয়ন্ত্রণ	Janma niẏantraṇa
তারিখ সার্টিফিকেট	Tārikha sārṭiphikēṭa
জন্ম	Janma
birdseed	Birdseed
birdbrained	Birdbrained
পাখি	Pākhi
বার্চ	Bārca
দ্বিপত্র বিমান	Dbipatra bimāna
দ্বিপদ	Dbipada
দ্বিদলীয়	Dbidalīẏa
বায়োপসি	Bāẏōpasi
জীববিদ্যা	Jībabidyā
জীববিজ্ঞানী	Jībabijñānī
আধিভৌতিক	Ādhibhautika
জীবনী	Jībanī
জীবনীসংক্রান্ত	Jībanīsaṅkrānta
জীবনীকার	Jībanīkāra
জীবাণুবিয়োজ্য	Jībāṇubiẏōjya
প্রাণরসায়ন	Prāṇarasāẏana
দুই চক্ষুর উপযোগী দূরবীক্ষণ	Du'i cakṣura upayōgī dūrabīkṣaṇa
লোটোখেলা	Lōṭōkhēlā
পানোত্সব	Pānōtsaba
বাঁধাই	Bām̐dhā'i
দপ্তরী	Daptarī
বাঁধাই করা	Bām̐dhā'i karā
বাইনারি	Bā'ināri
বিন	Bina
দ্বিমাসিক	Dbimāsika
মেয়েছেলে	Mēẏēchēlē
পাঁঠা	Pām̐ṭhā
উত্তাল তরঙ্গ	Uttāla taraṅga
অধিকার বিল	Adhikāra bila
billionth	Billionth
ধনকুবের	Dhanakubēra
বিলিয়ন	Biliẏana
বিলিয়ার্ড	Biliẏārḍa
পকেট ব্যাগ	Pakēṭa byāga
বিজ্ঞাপনের জন্য তক্তা	Bijñāpanēra jan'ya taktā
বিল	Bila
দ্বিভাষিক	Dbibhāṣika
পিত্ত	Pitta
দ্বিপক্ষীয়ভাবে	Dbipakṣīẏabhābē
দ্বিপার্শ্বিক	Dbipārśbika
বিকিনি	Bikini
বাইকার	Bā'ikāra
সাইকেল	Sā'ikēla
প্রধান লোক	Pradhāna lōka
বড় সময়	Baṛa samaẏa
বড় সময়	Baṛa samaẏa
বড় শট	Baṛa śaṭa
ধর্মান্ধতা	Dharmāndhatā
ধর্মান্ধ	Dharmāndha
ধর্মান্ধ	Dharmāndha
বড় নাম	Baṛa nāma
bigmouth	Bigmouth
বড় - লীগ	Baṛa - līga
বড় লীগ	Baṛa līga
বড় কিছু নয়	Baṛa kichu naẏa
বড় চুক্তি	Baṛa cukti
বড় পনির	Baṛa panira
বড় ভাই	Baṛa bhā'i
বিগ আপেল	Biga āpēla
দুই পত্নী গ্রহণ	Du'i patnī grahaṇa
দ্বিবিবাহ	Dbibibāha
দ্বিবিবাহকারী	Dbibibāhakārī
বিশাল	Biśāla
bifocals	Bifocals
দ্বিবার্ষিক	Dbibārṣika
সহা	Sahā
আদেশ	Ādēśa
যে নিকাম ডাকে	Yē nikāma ḍākē
যাঁরা নিমন্ত্রিত	Yām̐rā nimantrita
বিদার প্রস্তাব	Bidāra prastāba
সাইকেল	Sā'ikēla
বকাবকি	Bakābaki
দ্বিশির মাংসপেশী	Dbiśira mānsapēśī
দ্বিশততমবর্ষীয়	Dbiśatatamabarṣīẏa
অত্যধিক পান overalls	Atyadhika pāna overalls
গ্রন্থ-পঁজী	Grantha-pam̐jī
বাইবেলে উল্লিখিত	Bā'ibēlē ullikhita
বাইবেল	Bā'ibēla
বাইবেল	Bā'ibēla
বারংবার পান করা	Bārambāra pāna karā
পক্ষপাতদুষ্ট	Pakṣapātaduṣṭa
পক্ষপাত	Pakṣapāta
ছাড়াইয়া	Chāṛā'iẏā
মুগ্ধকর	Mugdhakara
বিহ্বলতা	Bihbalatā
বুদ্ধিভ্রংশজনক	Bud'dhibhranśajanaka
বুদ্ধিভ্রষ্ট	Bud'dhibhraṣṭa
হুঁশিয়ার	Hum̐śiẏāra
পানীয়	Pānīẏa
বেভেলড	Bēbhēlaḍa
মধ্যে	Madhyē
অপেক্ষাকৃত সঙ্গতিসম্পন্ন	Apēkṣākr̥ta saṅgatisampanna
উন্নতি	Unnati
উত্তম	Uttama
বিশ্বাসঘাতকতা	Biśbāsaghātakatā
বিশ্বাসঘাতকতা করা	Biśbāsaghātakatā karā
বাজি	Bāji
সেরা - সেলিং	Sērā - sēliṁ
জনপ্রি় বই	Janapri ba'i
দান করা	Dāna karā
নিতবর	Nitabara
পাশবিকতা	Pāśabikatā
পাশব	Pāśaba
সেরা	Sērā
অবরোধ করা	Abarōdha karā
তদ্ব্যতীত	Tadbyatīta
কাছে	Kāchē
বেষ্টন করা	Bēṣṭana karā
নোঙ্গরস্থান	Nōṅgarasthāna
পাগল	Pāgala
বেরি	Bēri
টুপিবিশেষ	Ṭupibiśēṣa
প্রি়জন-নিয়োগবিধুর	Prijana-niẏōgabidhura
আত্মীয়ের মৃতু্য	Ātmīẏēra mr̥tuya
প্রি়জন-নিয়োগবিধুর	Prijana-niẏōgabidhura
চোপা করা	Cōpā karā
অর্পিত দায়িত্ব	Arpita dāẏitba
ভারার্পণ করা	Bhārārpaṇa karā
নমিত	Namita
সদাশয়	Sadāśaẏa
হিতৈষী	Hitaiṣī
দয়াশীলতা	Daẏāśīlatā
সুবিধা	Subidhā
দানগ্রাহী	Dānagrāhī
উপকারী	Upakārī
হিতকারী	Hitakārī
আশীর্বচন	Āśīrbacana
তলদেশে	Taladēśē
মোড়	Mōṛa
বেঞ্চমার্ক	Bēñcamārka
ন্যায়াসন	N'yāẏāsana
বিমূঢ়	Bimūṛha
Beltway	Beltway
বেল্ট	Bēlṭa
নিচে	Nicē
দয়িত	Daẏita
জিনিসপত্র	Jinisapatra
অন্তর্গত	Antargata
bellybutton	Bellybutton
উদর	Udara
ঘণ্টা মরিচ	Ghaṇṭā marica
নর্দন	Nardana
যুদ্ধের অবস্থা	Yud'dhēra abasthā
ঘণ্টা - bottoms	Ghaṇṭā - bottoms
ঘণ্টা	Ghaṇṭā
তুচ্ছতাচ্ছিল্য করা	Tucchatācchilya karā
বিশ্বাসী	Biśbāsī
বিশ্বাস করা	Biśbāsa karā
বিশ্বাস্য	Biśbāsya
বিশ্বাস	Biśbāsa
আশানুরূপ	Āśānurūpa
উদ্গিরণ	Udgiraṇa
belatedly	Belatedly
অন্ধকারের মুখে পতিত	Andhakārēra mukhē patita
সত্তা	Sattā
ধূসরবর্ণ পশমি বস্ত্রবিশেষ	Dhūsarabarṇa paśami bastrabiśēṣa
দর্শক	Darśaka
দেখ দেখ	Dēkha dēkha
পিছনে	Pichanē
কতল করা	Katala karā
আচরণ	Ācaraṇa
আচরণ করা	Ācaraṇa karā
পক্ষ	Pakṣa
প্রক্রান্ত	Prakrānta
বিভ্রান্ত করা	Bibhrānta karā
রূষ্ট হত্তয়া	Rūṣṭa hattaẏā
শুরু	Śuru
শিক্ষানবিস	Śikṣānabisa
আরম্ভ করা	Ārambha karā
ভিক্ষুক	Bhikṣuka
শুরু	Śuru
প্রার্থনা করা	Prārthanā karā
বন্ধুত্ব স্থাপন করা	Bandhutba sthāpana karā
নির্দিষ্ট সময়ের পূর্বেই	Nirdiṣṭa samaẏēra pūrbē'i
আগে	Āgē
befitting	Befitting
শোভন হত্তয়া	Śōbhana hattaẏā
befell	Befell
befallen	Befallen
ঘটা	Ghaṭā
পোকা	Pōkā
বীট গাছ	Bīṭa gācha
মোম	Mōma
বিয়ার	Biẏāra
সিগন্যালম্যান	Sigan'yālamyāna
হুইসেল	Hu'isēla
হয়েছে	Haẏēchē
সরল রেখা	Sarala rēkhā
মৌচাক	Maucāka
নিরেট	Nirēṭa
গরুর মাংস	Garura mānsa
বীচবৃক্ষসংক্রান্ত	Bīcabr̥kṣasaṅkrānta
মৌমাছি	Maumāchi
শয়নকাল	Śaẏanakāla
শয্যাচ্ছাদনী	Śayyācchādanī
bedside	Bedside
শয়নকক্ষ	Śaẏanakakṣa
শয্যাশায়ী	Śayyāśāẏī
bedraggled	Bedraggled
রূগ্ণ ব্যক্তিদিগের জন্য শয্যায় মলত্যাগের পাত্রবিশেষ	Rūgṇa byaktidigēra jan'ya śayyāẏa malatyāgēra pātrabiśēṣa
পাগলা গারদ	Pāgalā gārada
বিছানাপত্র	Bichānāpatra
শয্যোপকরণ	Śayyōpakaraṇa
ছারপোকা	Chārapōkā
বেড এন্ড ব্রেকফাস্ট	Bēḍa ēnḍa brēkaphāsṭa
বিছানা	Bichānā
মানানসই	Mānānasa'i
হয়ে	Haẏē
ইশারা করা	Iśārā karā
এর কারণ	Ēra kāraṇa
কারণ	Kāraṇa
ওঠে	Ōṭhē
Bebop	Bebop
বীবর	Bībara
কেতাদোরস্ত প্রসাধনের ত্ত অঙ্গসজ্জার দোকান	Kētādōrasta prasādhanēra tta aṅgasajjāra dōkāna
সৌন্দর্য	Saundarya
সুন্দর	Sundara
সুন্দর	Sundara
প্রসাধনীয় থলি	Prasādhanīẏa thali
প্রহার	Prahāra
আঘাতকারী	Āghātakārī
প্রহৃত	Prahr̥ta
বীট	Bīṭa
জন্তু	Jantu
ভালুক বাজারে	Bhāluka bājārē
জন্মদান	Janmadāna
বাহক	Bāhaka
শ্মশ্রুধারী	Śmaśrudhārī
দাড়ি	Dāṛi
সহনীয়	Sahanīẏa
ভালুক	Bhāluka
শিম	Śima
মরীচি	Marīci
পানপাত্র	Pānapātra
ঠোঁট	Ṭhōm̐ṭa
গুপ্তচর	Guptacara
গুটিকাসদৃশ	Guṭikāsadr̥śa
গুটিকা	Guṭikā
বাতিঘর	Bātighara
সৈকত বল	Saikata bala
সৈকত	Saikata
থাকা	Thākā
বি.সি.	Bi.Si.
JadurKathi.com বাংলাদেশের	JadurKathi.Com bānlādēśēra
কাটরা	Kāṭarā
ঘুলঘুলি	Ghulaghuli
Bayou	Bayou
সঙ্গিন	Saṅgina
উপসাগর	Upasāgara
চিত্কার	Citkāra
অশ্লীল	Aślīla
রণতরী	Raṇatarī
যুদ্ধক্ষেত্র	Yud'dhakṣētra
যুদ্ধক্ষেত্র	Yud'dhakṣētra
যুদ্ধ	Yud'dha
ব্যাটারি	Byāṭāri
ক্ষত	Kṣata
পিটা	Piṭā
ব্যাটেলিয়ন	Byāṭēliẏana
রূল	Rūla
ব্যাট Mitzvah	Byāṭa Mitzvah
বাথটব	Bāthaṭaba
পায়খানা	Pāẏakhānā
bathrobe	Bathrobe
স্নান মামলা	Snāna māmalā
স্নান	Snāna
স্নান	Snāna
bated	Bated
ব্যাচ	Byāca
বাদুড়	Bāduṛa
জারজ	Jāraja
কাঠের বান্শিবিশেষ	Kāṭhēra bānśibiśēṣa
bassist	Bassist
খাদ গিটার	Khāda giṭāra
খাদ	Khāda
বাস্কেট কেস	Bāskēṭa kēsa
বাস্কেটবল	Bāskēṭabala
ঝুড়ি	Jhuṛi
পোয়ানো	Pōẏānō
ভিত্তি	Bhitti
গামলা	Gāmalā
মূলসূত্র	Mūlasūtra
মূলত	Mūlata
মৌলিক	Maulika
bashing	Bashing
লাজুক	Lājuka
সজোরে আঘাত	Sajōrē āghāta
ঘাঁটি	Ghām̐ṭi
বুনিয়াদ	Buniẏāda
বেসবল	Bēsabala
ভিত্তি	Bhitti
বিনিময়	Binimaẏa
মদের দোকানের পরিবেষক	Madēra dōkānēra paribēṣaka
barroom	Barroom
Barrio	Barrio
ছাড়া	Chāṛā
বাধা	Bādhā
ব্যারিকেড	Byārikēḍa
অনুর্বর	Anurbara
পিপা	Pipā
বাঁধ	Bām̐dha
ব্যারাকে	Byārākē
ব্যারন	Byārana
আবহমানসংক্রান্ত	Ābahamānasaṅkrānta
আবহমানযন্ত্র	Ābahamānayantra
barnyard	Barnyard
রাজহংসবিশেষ	Rājahansabiśēṣa
শস্যাগার	Śasyāgāra
বার Mitzvah	Bāra Mitzvah
যব	Yaba
বাকল	Bākala
ব্যারিটন	Byāriṭana
বজরা	Bajarā
কারবারী চিপ	Kārabārī cipa
ক্রয়বিক্রয়	Kraẏabikraẏa
Barf	Barf
সবে	Sabē
নগ্নপদে	Nagnapadē
বেয়ার হাড়	Bēẏāra hāṛa
খালি	Khāli
বার কোড	Bāra kōḍa
নিদ্রা-উদ্রেককর ঔষধবিশেষ	Nidrā-udrēkakara auṣadhabiśēṣa
নাপিত	Nāpita
বারবেল	Bārabēla
কাঁটাতার	Kām̐ṭātāra
কাবাব	Kābāba
বর্বরতা	Barbaratā
আদিম	Ādima
অসভ্য	Asabhya
বার	Bāra
খ্রীষ্টধর্মে দীক্ষা দেত্তয়া	Khrīṣṭadharmē dīkṣā dēttaẏā
অভিসিঁচনকারী	Abhisim̐canakārī
পবিত্র অভিসিঁচনসংক্রান্ত	Pabitra abhisim̐canasaṅkrānta
যুদ্ধের অভিজ্ঞতা	Yud'dhēra abhijñatā
পরিহাস	Parihāsa
ভোজ	Bhōja
নিশান	Niśāna
দেউলিয়া	Dē'uliẏā
দেউলিয়া	Dē'uliẏā
ব্যাংকিং	Byāṅkiṁ
মহাজন	Mahājana
ব্যাংক	Byāṅka
তারের বাদ্যযন্ত্রবিশেষ	Tārēra bādyayantrabiśēṣa
ক্ষুদ্র স্তম্ভ	Kṣudra stambha
খেদান	Khēdāna
চৌকো করে কাটা	Caukō karē kāṭā
বালা	Bālā
ঠুং	Ṭhuṁ
সর্বনাশ	Sarbanāśa
হকিখেলা	Hakikhēlā
জনপ্রি়তার গাড়ি	Janapritāra gāṛi
ঐকতানবাদের জন্য স্থায়ী মঁচ	Aikatānabādēra jan'ya sthāẏī mam̐ca
ডাকাত	Ḍākāta
রূমালবিশেষ	Rūmālabiśēṣa
ব্যান্ড - এইড	Byānḍa - ē'iḍa
ব্যাণ্ডেজ	Byāṇḍēja
দল	Dala
কলা	Kalā
তুচ্ছতা	Tucchatā
গতানুগতিক	Gatānugatika
নিষেধাজ্ঞা	Niṣēdhājñā
বোকা বানান	Bōkā bānāna
বাঁশ	Bām̐śa
বাজে কথা	Bājē kathā
প্রশমনকারী	Praśamanakārī
সুগন্ধ পদার্থ	Sugandha padārtha
বাজে কথা	Bājē kathā
নৃত্যশালা	Nr̥tyaśālā
কলম	Kalama
ballpark	Ballpark
ভোটপত্র	Bhōṭapatra
বেলুন	Bēluna
নিক্ষিপ্ত অস্ত্রাদি-সংক্রান্ত বিদ্যা	Nikṣipta astrādi-saṅkrānta bidyā
ক্ষেপণাস্ত্র সম্পর্কীয়	Kṣēpaṇāstra samparkīẏa
কার্যক্ষেত্র	Kāryakṣētra
ব্যালে	Byālē
নর্তকী	Nartakī
গাথা	Gāthā
বল	Bala
কড়িকাঠ	Kaṛikāṭha
বিপর্যয়কর	Biparyaẏakara
অনিষ্ট	Aniṣṭa
balding	Balding
পালকহীন ঈগল	Pālakahīna īgala
পালকহীন	Pālakahīna
অলিন্দ	Alinda
নিকাশ	Nikāśa
ক্ষমতার ভারসাম্য	Kṣamatāra bhārasāmya
সুষম	Suṣama
ভারসাম্য	Bhārasāmya
বেকারি	Bēkāri
রূটিত্তয়ালা	Rūṭittaẏālā
সেকা	Sēkā
টোপ	Ṭōpa
সাধ্যপাল	Sādhyapāla
জামিন	Jāmina
bagpipes	Bagpipes
ব্যাগ ভদ্রমহিলা	Byāga bhadramahilā
বেঢপ	Bēḍhapa
পোঁটলা	Pōm̐ṭalā
bagel	Bagel
ব্যাগ	Byāga
বিভ্রান্তিকর	Bibhrāntikara
Baffled	Baffled
কিংকর্তব্যবিমূঢ় করা	Kiṅkartabyabimūṛha karā
কলঙ্কিত করা	Kalaṅkita karā
ব্যাডমিন্টন	Byāḍaminṭana
খারাপভাবে	Khārāpabhābē
কটুকাটব্য	Kaṭukāṭabya
অনুর্বর জমি	Anurbara jami
ব্যাজার	Byājāra
ব্যাজ	Byāja
Bade	Bade
খারাপ	Khārāpa
ব্যাকটেরিয়া	Byākaṭēriẏā
বেকন	Bēkana
বাড়ির পিছনের দিকের উঠোন	Bāṛira pichanēra dikēra uṭhōna
গ্রামের প্রান্তস্থিত বন	Grāmēra prāntasthita bana
পিছে	Pichē
অনগ্রসর	Anagrasara
ব্যাকআপ	Byāka'āpa
প্রত্যাখ্যান করা	Pratyākhyāna karā
চিত্সাঁতার	Citsām̐tāra
গোপনে	Gōpanē
পাছ	Pācha
নিম্নস্থান	Nimnasthāna
Backpacker	Backpacker
ব্যাকপ্যাক	Byākapyāka
জমা কাজ	Jamā kāja
নেতিবাচক প্রতিক্রিয়া	Nētibācaka pratikriẏā
সমর্থন	Samarthana
প্যাঁচালো	Pyām̐cālō
backhand	Backhand
পটভূমি	Paṭabhūmi
ব্যাকগ্যামন	Byākagyāmana
বিপর্যয় ঘটা	Biparyaẏa ghaṭā
সমর্থক	Samarthaka
পরিপ্রেক্ষিত	Pariprēkṣita
backbreaking	Backbreaking
দাঁড়া	Dām̐ṛā
পিছনে	Pichanē
কুমার	Kumāra
ঠিকা ছেলে-ধরনি	Ṭhikā chēlē-dharani
babysit	Babysit
babysat	Babysat
ঠেলাগাড়ি	Ṭhēlāgāṛi
শিশুর ক্যাঙ্গারুর নর	Śiśura kyāṅgārura nara
শিশুর গম্ভীর গর্জন	Śiśura gambhīra garjana
বাচ্চা	Bāccā
বানরজাতীয় প্রাণিবিশেষ	Bānarajātīẏa prāṇibiśēṣa
খোকামনি	Khōkāmani
কলধ্বনি	Kaladhbani
ছাগলের ডাক	Chāgalēra ḍāka
বিএ	Bi'ē
প্রত্যক্ষ সাক্ষী	Pratyakṣa sākṣī
চক্ষুশূল	Cakṣuśūla
দৃষ্টিশক্তি	Dr̥ṣṭiśakti
চোখের ছায়া	Cōkhēra chāẏā
চোখ খুলে	Cōkha khulē
eyeliner	Eyeliner
নেত্রপল্লব	Nētrapallaba
পক্ষ্ম	Pakṣma
চশমা	Caśamā
আকর্ষণীয়	Ākarṣaṇīẏa
ভুরু	Bhuru
অক্ষিগোলক	Akṣigōlaka
চোখ	Cōkha
উল্লাস	Ullāsa
উল্লসিত	Ullasita
অতিশয় আনন্দ করা	Atiśaẏa ānanda karā
ঝরান	Jharāna
উচ্ছ্বাসিত	Ucchbāsita
উদ্দীপনা	Uddīpanā
extroverted	Extroverted
বহির্মুখ	Bahirmukha
মুক্ত করা	Mukta karā
প্রান্তসীমা	Prāntasīmā
পা	Pā
চরমপন্থী	Caramapanthī
চরমপন্থা	Caramapanthā
অত্যন্ত	Atyanta
চরম	Carama
extravagantly	Extravagantly
অসংযত	Asanyata
অপচয়	Apacaẏa
extraterrestrial	Extraterrestrial
পূর্বেই দেখা	Pūrbē'i dēkhā
অসাধারণ	Asādhāraṇa
খুব	Khuba
পরক	Paraka
বহি: সমর্পন	Bahi: Samarpana
যোগ্য কর্তৃপক্ষ হস্তে সমর্পন করা	Yōgya kartr̥pakṣa hastē samarpana karā
নিয়মিত পাঠক্রম বহির্ভূত	Niẏamita pāṭhakrama bahirbhūta
নিষ্কাশন	Niṣkāśana
সার	Sāra
অতিরিক্ত	Atirikta
অত্যাচারী	Atyācārī
বলপ্রয়োগ আদায় করা	Balapraẏōga ādāẏa karā
দোহন	Dōhana
উচ্চপ্রশংসা করা	Uccapraśansā karā
নির্বাপক	Nirbāpaka
নিভান	Nibhāna
বিলোপ	Bilōpa
লুপ্ত	Lupta
বহিরাগত	Bahirāgata
উন্মুলয়িতা	Unmulaẏitā
উন্মূলন	Unmūlana
উপড়াইয়া ফেলা	Upaṛā'iẏā phēlā
বহি	Bahi
ব্যাপ্তি	Byāpti
ব্যাপকভাবে	Byāpakabhābē
ব্যাপক	Byāpaka
প্রসার	Prasāra
বর্ধিত পরিবার	Bardhita paribāra
প্রসারিত করা	Prasārita karā
অনিয়মিত	Aniẏamita
অত্যন্ত সুন্দরভাবে	Atyanta sundarabhābē
সূক্ষ্ম	Sūkṣma
নির্বাসন	Nirbāsana
বাজেয়াপ্তকরণ	Bājēẏāptakaraṇa
দখলচু্যত করা	Dakhalacuyata karā
মোটর রাজপথ	Mōṭara rājapatha
স্পষ্টভাবে	Spaṣṭabhābē
expressively	Expressively
ভাবপূর্ণ	Bhābapūrṇa
অভিব্যক্তি	Abhibyakti
দ্রুতগামী	Drutagāmī
প্রকাশ	Prakāśa
উদ্ভাস	Udbhāsa
উদ্ভাসিত	Udbhāsita
খুলা	Khulā
রপ্তানিকারক	Raptānikāraka
রপ্তানিকরণ	Raptānikaraṇa
রপ্তানি	Raptāni
সূচক	Sūcaka
উত্পন্ন দ্রব্যাদির আন্তর্জাতিক প্রদর্শনী	Utpanna drabyādira āntarjātika pradarśanī
বিস্ফোরক	Bisphōraka
বিস্ফোরণ	Bisphōraṇa
অনুসন্ধানকারী	Anusandhānakārī
অন্বেষণ করা	Anbēṣaṇa karā
অনুসন্ধানাত্মক	Anusandhānātmaka
অনুসন্ধান	Anusandhāna
শোষণ	Śōṣaṇa
কাজে লাগান	Kājē lāgāna
বিস্ফোরিত করা	Bisphōrita karā
স্পষ্টভাবে	Spaṣṭabhābē
স্পষ্ট	Spaṣṭa
কহতব্য	Kahatabya
অনুপূরক	Anupūraka
ব্যাখ্যামূলক	Byākhyāmūlaka
ব্যাখ্যা	Byākhyā
ব্যাখ্যা করা	Byākhyā karā
মেয়াদ শেষ	Mēẏāda śēṣa
মেয়াদ শেষের তারিখ	Mēẏāda śēṣēra tārikha
মৃতু্য	Mr̥tuya
expertly	Expertly
অভিজ্ঞতা	Abhijñatā
বিশেষজ্ঞ	Biśēṣajña
পরীক্ষা	Parīkṣā
পরীক্ষামূলকভাবে	Parīkṣāmūlakabhābē
পরীক্ষামূলক	Parīkṣāmūlaka
পরীক্ষা	Parīkṣā
অভিজ্ঞ	Abhijña
অভিজ্ঞতা	Abhijñatā
expensively	Expensively
ব্যয়বহুল	Byaẏabahula
খরচ	Kharaca
ব্যয় অ্যাকাউন্ট	Byaẏa ayākā'unṭa
ব্যয়	Byaẏa
ব্যয়	Byaẏa
ব্যয় করা যয় এমন	Byaẏa karā yaẏa ēmana
ব্যয় করা	Byaẏa karā
বিতাড়িত করা	Bitāṛita karā
অভিযান	Abhiyāna
সুবিধাযুক্ত	Subidhāyukta
সমীচীন	Samīcīna
যুক্তিযুক্ততা	Yuktiyuktatā
প্রত্যাশা	Pratyāśā
হাসে	Hāsē
প্রত্যাশী	Pratyāśī
প্রত্যাশা	Pratyāśā
আশা করা	Āśā karā
নির্বাসিত ব্যক্তি	Nirbāsita byakti
অকপট	Akapaṭa
সম্প্রসারণবাদী	Samprasāraṇabādī
সম্প্রসারণ	Samprasāraṇa
বিস্তৃতি	Bistr̥ti
সম্প্রসারিত	Samprasārita
বিস্তৃত করা	Bistr̥ta karā
বহিরাগত	Bahirāgata
ভূতের রাজা	Bhūtēra rājā
গুণ	Guṇa
গলাকাটা	Galākāṭā
ক্ষালন	Kṣālana
ক্ষালন করা	Kṣālana karā
প্রস্থান	Prasthāna
প্রস্থান ঢালু	Prasthāna ḍhālu
প্রস্থান পোল	Prasthāna pōla
প্রস্থান	Prasthāna
বিদ্যমান	Bidyamāna
অস্তিত্ব	Astitba
উপস্থিত থাকা	Upasthita thākā
নির্বাসন	Nirbāsana
কবর হতে তোলা	Kabara hatē tōlā
প্রকাশ করা	Prakāśa karā
পরামর্শ	Parāmarśa
উত্সাহিত করা	Utsāhita karā
উল্লাস	Ullāsa
উল্লাসজনক	Ullāsajanaka
প্রাণবন্ত করা	Prāṇabanta karā
প্রদর্শক	Pradarśaka
exhibitionist	Exhibitionist
অঙ্গের অশোভনীয় অনাবৃত অবস্থা	Aṅgēra aśōbhanīẏa anābr̥ta abasthā
প্রদর্শনী খেলা	Pradarśanī khēlā
প্রদর্শনী	Pradarśanī
প্রদর্শক	Pradarśaka
exhaustively	Exhaustively
সম্পূর্ণ	Sampūrṇa
অবসাদ	Abasāda
ক্লান্তিকর	Klāntikara
ক্লান্ত	Klānta
এক্সস্ট	Ēksasṭa
বাষ্পীভূত করা	Bāṣpībhūta karā
উদ্যম	Udyama
জাহির করা	Jāhira karā
ব্যায়াম	Byāẏāma
রেহাই	Rēhā'i
অব্যাহতিপ্রাপ্ত	Abyāhatiprāpta
উদাহরণ দ্বারা ব্যাখ্যা করা	Udāharaṇa dbārā byākhyā karā
অনুকরণীয়	Anukaraṇīẏa
নির্বাহক	Nirbāhaka
কার্যনির্বাহী	Kāryanirbāhī
জল্লাদ	Jallāda
ফাঁসি	Phām̐si
নির্বাহ করা	Nirbāha karā
Exec	Exec
ক্ষমা	Kṣamā
মার্জনীয়	Mārjanīẏa
ভ্রমণ	Bhramaṇa
excruciatingly	Excruciatingly
মর্মযন্ত্রণাপূর্ণ	Marmayantraṇāpūrṇa
নাদা	Nādā
বিষ্ঠা	Biṣṭhā
লেজার নির্দেশক	Lējāra nirdēśaka
সমাজচু্যত করা	Samājacuyata karā
কেবলমাত্র	Kēbalamātra
একচেটিয়া	Ēkacēṭiẏā
বর্জন	Barjana
অপসারণ	Apasāraṇa
বহিষ্কৃত করা	Bahiṣkr̥ta karā
বিস্ময়বোধক বিন্দু	Bismaẏabōdhaka bindu
উচ্চ শব্দ	Ucca śabda
চীত্কার করা	Cītkāra karā
উত্তেজনাপূর্ণ	Uttējanāpūrṇa
উত্তেজনা	Uttējanā
ব্যস্ততাসহকারে	Byastatāsahakārē
অধীর	Adhīra
জাগান	Jāgāna
উত্তেজনক্ষম	Uttējanakṣama
ছেদন	Chēdana
আবগারি	Ābagāri
বিনিময় হার	Binimaẏa hāra
বিনিময়	Binimaẏa
বেজায়	Bējāẏa
অত্যধিক	Atyadhika
বাহুল্যও	Bāhulya'ō
বাড়তি	Bāṛati
উদ্ধৃতাংশ	Ud'dhr̥tānśa
অত্যন্ত	Atyanta
ব্যতিক্রমী	Byatikramī
ব্যতিক্রম	Byatikrama
ছাড়া	Chāṛā
চমত্কার	Camatkāra
সম্যক্	Samyak
সীমা অতিক্রম করা	Sīmā atikrama karā
শ্রেষ্ঠত্ব	Śrēṣṭhatba
অতীব	Atība
অতিক্রম করা	Atikrama karā
খনন	Khanana
খুঁড়া	Khum̐ṛā
উত্তেজনা	Uttējanā
অতিশয় বিরক্তিকর	Atiśaẏa biraktikara
exasperated	Exasperated
ক্রুদ্ধ করা	Krud'dha karā
উদাহরণ	Udāharaṇa
পরীক্ষক	Parīkṣaka
পরীক্ষা করা	Parīkṣā karā
পরীক্ষা	Parīkṣā
পরীক্ষা	Parīkṣā
উল্লাস	Ullāsa
মহিমান্বিত করা	Mahimānbita karā
রঙ	Raṅa
ফলাও	Phalā'ō
ফলান	Phalāna
ঠিক	Ṭhika
ছিদ্রান্বেষী	Chidrānbēṣī
সঠিক	Saṭhika
বর্ধিত করা	Bardhita karā
অপ	Apa
ভেড়ী	Bhēṛī
গজান	Gajāna
অভিব্যক্তিমূলক	Abhibyaktimūlaka
বিবর্তন	Bibartana
আহ্বান করা	Āhbāna karā
শিল্পানুগ	Śilpānuga
মন্দ	Manda
স্পষ্টরূপে	Spaṣṭarūpē
স্পষ্ট	Spaṣṭa
প্রমাণ	Pramāṇa
উচ্ছেদ	Ucchēda
উচ্ছেদ করা	Ucchēda karā
সর্বত্র	Sarbatra
সব	Saba
everyplace	Everyplace
সবাই	Sabā'i
দৈনন্দিন	Dainandina
সবাই	Sabā'i
প্রতি	Prati
সতত	Satata
অনন্ত	Ananta
চিরহরিৎ	Cirahariṯ
নিত্য	Nitya
অবশেষে	Abaśēṣē
পরিণাম	Pariṇāma
পরিণামস্বরূপ	Pariṇāmasbarūpa
ঘটনাবহুল	Ghaṭanābahula
ঘটনা	Ghaṭanā
evenness	Evenness
সমান	Samāna
সন্ধ্যায়	Sandhyāẏa
সন্ধ্যা	Sandhyā
evenhanded	Evenhanded
এমন কি	Ēmana ki
ইভ	Ibha
অসরল	Asarala
ছল	Chala
বাষ্পীভবন	Bāṣpībhabana
উবা	Ubā
ধর্মপ্রচারক	Dharmapracāraka
ধর্মপ্রচার	Dharmapracāra
খ্রীষ্টীয় ঘটিত	Khrīṣṭīẏa ghaṭita
মূল্যায়ন	Mūlyāẏana
সংখ্যা নির্ণয় করা	Saṅkhyā nirṇaẏa karā
টালা	Ṭālā
উদ্বাস্তু	Udbāstu
উদ্বাসন	Udbāsana
পায়খানা করা	Pāẏakhānā karā
আরামের মরণ	Ārāmēra maraṇa
ইউরোপীয়	I'urōpīẏa
ইউরোপ	I'urōpa
euphoric	Euphoric
রমরমা	Ramaramā
euphemistically	Euphemistically
euphemistic	Euphemistic
euphemism	Euphemism
নপুংসক	Napunsaka
বাখান	Bākhāna
স্তুতি করা	Stuti karā
ব্যাকরণ	Byākaraṇa
শিষ্টাচার	Śiṣṭācāra
জাতিগত	Jātigata
নীতিশাস্ত্র	Nītiśāstra
নীতিগত	Nītigata
নৈতিক	Naitika
নৈতিক	Naitika
গগনচারী	Gaganacārī
থার	Thāra
অনন্তকাল	Anantakāla
eternally	Eternally
অনন্ত	Ananta
খোদাই করা	Khōdā'i karā
প্রভৃতি	Prabhr̥ti
এট আল.	Ēṭa āla.
মোহনা	Mōhanā
ইস্ট্রজেন	Isṭrajēna
বিরোধ	Birōdha
বিছিন্ন	Bichinna
প্রাক্কলন	Prākkalana
আনুমানিক	Ānumānika
হিসাব	Hisāba
শ্রদ্ধেয়	Śrad'dhēẏa
esthetically	Esthetically
সৌন্দর্যবোধবিশিষ্ট	Saundaryabōdhabiśiṣṭa
উচ্চমূল্য	Uccamūlya
স্টেট	Sṭēṭa
সংস্থাপন	Sansthāpana
স্থাপন করা	Sthāpana karā
মূলত	Mūlata
অপরিহার্য	Aparihārya
সারাংশ	Sārānśa
প্রবন্ধ	Prabandha
এসপ্রেসো	Ēsaprēsō
বিবাহ করা	Bibāha karā
গুপ্তচরবৃত্তি	Guptacarabr̥tti
বিশেষত	Biśēṣata
ESP .	ESP.
ESP	ESP
গূঢ়	Gūṛha
অন্ননালী	Annanālī
ইএসএল	I'ēsa'ēla
এস্কিমো	Ēskimō
সহচর	Sahacara
পরিহার করা	Parihāra karā
পলায়নী প্রবৃত্তিপূর্ণ	Palāẏanī prabr̥ttipūrṇa
পলায়নী প্রবৃত্তি	Palāẏanī prabr̥tti
পলান	Palāna
অব্যাহতি	Abyāhati
পলায়ন	Palāẏana
চলন্ত সিঁড়ি	Calanta sim̐ṛi
তীব্রতাবৃদ্ধি	Tībratābr̥d'dhi
ধাপে ধাপে বৃদ্ধি করা	Dhāpē dhāpē br̥d'dhi karā
অগ্ন্যুত্পাত	Agn'yutpāta
বিস্ফোরণ হত্তয়া	Bisphōraṇa hattaẏā
বিদ্যা	Bidyā
জ্ঞানী	Jñānī
ভুল	Bhula
ভ্রান্ত	Bhrānta
ভ্রান্তভাবে	Bhrāntabhābē
erratically	Erratically
অনিশ্চিত	Aniścita
ভ্রমণরত	Bhramaṇarata
প্রেরিত বার্তা	Prērita bārtā
ভুল করা	Bhula karā
eroticism	Eroticism
erotically	Erotically
প্রেমমূলক	Prēmamūlaka
ক্ষয়	Kṣaẏa
ক্ষয় করা	Kṣaẏa karā
ইমারত	Imārata
খাড়া	Khāṛā
রবার	Rabāra
নিশ্চিহ্ন করা	Niścihna karā
উচ্ছেদ	Ucchēda
সমূলে উত্পাটন করা	Samūlē utpāṭana karā
যুগ	Yuga
ইআর	I'āra
সন্দেহজনক	Sandēhajanaka
সমতুল্য	Samatulya
সমানতা	Samānatā
ইকুইটি	Iku'iṭi
ন্যায়সঙ্গত	N'yāẏasaṅgata
সজ্জিত	Sajjita
উপকরণ	Upakaraṇa
প্রস্তুত করা	Prastuta karā
বিষুব	Biṣuba
অশ্বতুল্য	Aśbatulya
সুস্থিতি	Susthiti
সমবাহু	Samabāhu
অশ্বারূঢ়	Aśbārūṛha
নিরক্ষীয়	Nirakṣīẏa
বিষুবরেখা	Biṣubarēkhā
সমীকরণ	Samīkaraṇa
সমীকরণ করা	Samīkaraṇa karā
মনের সমতা	Manēra samatā
সমান চিহ্ন	Samāna cihna
সমানভাবে	Samānabhābē
সমান করা	Samāna karā
সমতা	Samatā
সমান	Samāna
কাল	Kāla
চুম্বক করা	Cumbaka karā
সংক্ষিপ্তসার	Saṅkṣiptasāra
বিশেষণ	Biśēṣaṇa
সমাধিস্তম্ভ-লিপি	Samādhistambha-lipi
পত্র	Patra
অনিয়মিত	Aniẏamita
উপাখ্যান	Upākhyāna
বিশপ-সংক্রান্ত	Biśapa-saṅkrānta
এপিসকোপাল চার্চ	Ēpisakōpāla cārca
পরিশেষ	Pariśēṣa
মৃগীরোগী	Mr̥gīrōgī
মৃগীরোগ	Mr̥gīrōga
শ্লেষ	Ślēṣa
মহামারী	Mahāmārī
উপকেন্দ্র	Upakēndra
মহাকাব্য	Mahākābya
ক্ষণজীবী	Kṣaṇajībī
সৈন্যদের স্কন্ধোপরিস্থ বিহ্ন	Sain'yadēra skandhōparistha bihna
উত্সেচক	Utsēcaka
দ্বেষ	Dbēṣa
দূত	Dūta
কল্পনা করা	Kalpanā karā
বিবেচনা	Bibēcanā
শহরতলি	Śaharatali
পরিবেশ	Paribēśa
পরিবেশবিদ	Paribēśabida
পরিবেশগত	Paribēśagata
পরিবেশ	Paribēśa
enviously	Enviously
পরশ্রীকাতর	Paraśrīkātara
বাঁছনীয়	Bām̐chanīẏa
খাম	Khāma
মোড়া	Mōṛā
উক্তি	Ukti
বিবৃত করা	Bibr̥ta karā
গনা	Ganā
বয়ন করা	Baẏana karā
entryway	Entryway
এন্ট্রি - স্তরের	Ēnṭri - starēra
প্রবেশ	Prabēśa
বিশ্বাস স্থাপন করা	Biśbāsa sthāpana karā
উদ্যোক্তা	Udyōktā
ব্যবসায়ে ঝুঁকিদার	Byabasāẏē jhum̐kidāra
প্রবেশাধিকার	Prabēśādhikāra
অনুরোধ	Anurōdha
অনুনয় করা	Anunaẏa karā
entrapment	Entrapment
ফাঁদে ধরা	Phām̐dē dharā
প্রবেশক	Prabēśaka
প্রবেশদ্বার ঢালু	Prabēśadbāra ḍhālu
প্রবেশদ্বার	Prabēśadbāra
অন্ত্র	Antra
পরিপার্শ্ব	Paripārśba
পতঙ্গবিজ্ঞান	Pataṅgabijñāna
পতঙ্গবিজ্ঞানী	Pataṅgabijñānī
সত্তা	Sattā
এনটাইটেলমেন্টের	Ēnaṭā'iṭēlamēnṭēra
স্বত্ববান	Sbatbabāna
আখ্যাত করা	Ākhyāta karā
সম্পূর্ণতা	Sampūrṇatā
সম্পূর্ণরূপে	Sampūrṇarūpē
সমগ্র	Samagra
enticing	Enticing
প্রলোভন	Pralōbhana
প্রলুব্ধ করা	Pralubdha karā
উৎসাহের	Uṯsāhēra
উত্সাহী	Utsāhī
কৌতূহলী ব্যক্তি	Kautūhalī byakti
উদ্যম	Udyama
উদ্যমী করান	Udyamī karāna
enthralling	Enthralling
দাসত্বে আবদ্ধ করা	Dāsatbē ābad'dha karā
বিনোদন	Binōdana
রসাল	Rasāla
বিনোদনকারী	Binōdanakārī
পোষণ করা	Pōṣaṇa karā
উচ্চাভিলাষী	Uccābhilāṣī
উদ্যোগ	Udyōga
প্রবেশ করান	Prabēśa karāna
জড়াইয়া পড়া	Jaṛā'iẏā paṛā
বিজড়িত	Bijaṛita
বিপর্যস্ত করা	Biparyasta karā
ফলস্বরূপ ঘটা	Phalasbarūpa ghaṭā
নিশ্চিত করা	Niścita karā
আসন্ন	Āsanna
ঘটা	Ghaṭā
পতাকাবাহী	Patākābāhī
মন্দিরমধ্যে রক্ষা করা	Mandiramadhyē rakṣā karā
আঁসাঁব্ল	Ām̐sām̐bla
দৃঢ়ভাবে প্রতিষ্ঠিত করা	Dr̥ṛhabhābē pratiṣṭhita karā
যাইবার পথে	Yā'ibāra pathē
নিয়োগ	Niẏōga
নথিভুক্ত করা	Nathibhukta karā
সমৃদ্ধি	Samr̥d'dhi
সমৃদ্ধ করা	Samr̥d'dha karā
খাপ্পা	Khāppā
যথেষ্ট	Yathēṣṭa
পাগল করা	Pāgala karā
বৃহদাকার	Br̥hadākāra
বিশালতা	Biśālatā
অতিশয়	Atiśaẏa
শত্রুতা	Śatrutā
সার্বজনীনভাবে	Sārbajanīnabhābē
উদ্দীপ্ত করা	Uddīpta karā
তালিকাভুক্তি	Tālikābhukti
পক্ষভুক্ত করা	Pakṣabhukta karā
জ্ঞানগর্ভ	Jñānagarbha
আলোকিত	Ālōkita
জ্বালান	Jbālāna
পরিবর্ধন	Paribardhana
সম্প্রসারিত করা	Samprasārita karā
রমণ	Ramaṇa
উপভোগ্য	Upabhōgya
ভোগ	Bhōga
হেঁয়ালিপূর্ণ	Hēm̐ẏālipūrṇa
হেঁয়ালি	Hēm̐ẏāli
বৃদ্ধি	Br̥d'dhi
উন্নত করা	Unnata karā
ভরা	Bharā
চিত্তাকর্ষক	Cittākarṣaka
নিমজ্জিত	Nimajjita
খোদাই	Khōdā'i
খুদা	Khudā
ইংরেজি	Inrēji
প্রকৌশল	Prakauśala
প্রকৌশলী	Prakauśalī
ইঞ্জিন	Iñjina
প্রসব করা	Prasaba karā
আকর্ষক	Ākarṣaka
বাগ্দানের নিদর্শনস্বরূপ আংটি	Bāgdānēra nidarśanasbarūpa āṇṭi
প্রবৃত্তি	Prabr̥tti
জড়িত	Jaṛita
চুক্তিবদ্ধ করান	Cuktibad'dha karāna
স্বাধীনতা দেত্তয়া	Sbādhīnatā dēttaẏā
বলবত্করণ	Balabatkaraṇa
শক্য	Śakya
জোরদার করা	Jōradāra karā
শক্তি	Śakti
প্রবলভাবে সক্রিয় করা	Prabalabhābē sakriẏa karā
শক্তি	Śakti
জীবন্তভাবে	Jībantabhābē
অনলস	Analasa
শত্রু	Śatru
শেষ জোন	Śēṣa jōna
স্থায়ী	Sthāẏī
সহ্য করা	Sahya karā
সহনশীলতা	Sahanaśīlatā
বৃত্তিদান	Br̥ttidāna
বুদ্ধি দ্বারা অলঙ্কৃত করা	Bud'dhi dbārā alaṅkr̥ta karā
পৃষ্ঠাঙ্কন	Pr̥ṣṭhāṅkana
অনুমোদন করা	Anumōdana karā
endlessly	Endlessly
অবিরাম	Abirāma
endive	Endive
শেষ	Śēṣa
স্থানীয়	Sthānīẏa
উপক্রম	Upakrama
আদর	Ādara
স্নেহসঞ্চারক	Snēhasañcāraka
আদরণীয় করা	Ādaraṇīẏa karā
বিপন্ন প্রজাতি	Bipanna prajāti
বিপন্ন	Bipanna
বিপন্ন করা	Bipanna karā
শেষ	Śēṣa
বিশ্বকোষ	Biśbakōṣa
বোঝা	Bōjhā
ব্যাহত করা	Byāhata karā
সীমালঙ্ঘন করা	Sīmālaṅghana karā
উত্তেজক	Uttējaka
অনুপ্রেরণা	Anuprēraṇā
উত্সাহিত করা	Utsāhita karā
সাক্ষাৎ	Sākṣāṯ
আর একবার	Āra ēkabāra
পরিবেষ্টন করা	Paribēṣṭana karā
ঘের	Ghēra
ঘিরা	Ghirā
ছিটমহল	Chiṭamahala
পরিবেষ্টন করা	Paribēṣṭana karā
enchilada	Enchilada
মোহন	Mōhana
মায়াময়	Māẏāmaẏa
বাঁধা	Bām̐dhā
প্রেমমুগ্ধ	Prēmamugdha
কলাই	Kalā'i
সক্রিয়	Sakriẏa
বিহিত করা	Bihita karā
অনুকরণ করা	Anukaraṇa karā
খালিহাতে	Khālihātē
খালি	Khāli
শূন্যতা	Śūn'yatā
রাজরাজেশ্বরী	Rājarājēśbarī
ক্ষমতায়ন	Kṣamatāẏana
ক্ষমতাপ্রদান করা	Kṣamatāpradāna karā
বড়বাজার	Baṛabājāra
কর্মসংস্থান সংস্থা	Karmasansthāna sansthā
চাকরি	Cākari
নিয়োগকর্তা	Niẏōgakartā
কর্মচারী	Karmacārī
চাকরী	Cākarī
গবেষণামূলক	Gabēṣaṇāmūlaka
সাম্রাজ্য	Sāmrājya
এমফিসেমা	Ēmaphisēmā
সজোরে	Sajōrē
সতেজ	Satēja
গুরুত্ব আরোপ করা	Gurutba ārōpa karā
জোর	Jōra
emphases	Emphases
সম্রাট	Samrāṭa
সহানুভূতি	Sahānubhūti
empathize	Empathize
আবেগপ্রবণ	Ābēgaprabaṇa
আবেগের	Ābēgēra
আবেগপ্রবণ	Ābēgaprabaṇa
আবেগ	Ābēga
এমি	Ēmi
প্রেরণ করা	Prēraṇa karā
নির্গমন	Nirgamana
গুপ্তচর	Guptacara
আমিরশাহী	Āmiraśāhī
আমির	Āmira
মাত্রাতিরিক্তভাবে	Mātrātiriktabhābē
বিশিষ্ট	Biśiṣṭa
প্রবাস	Prabāsa
বাসস্থান বদলান	Bāsasthāna badalāna
দেশান্তরী	Dēśāntarī
শিরিস বোর্ড	Śirisa bōrḍa
এমেরিটাস	Ēmēriṭāsa
উত্থানশীল	Ut'thānaśīla
আপত্কালীন কক্ষ	Āpatkālīna kakṣa
ইমার্জেন্সি ব্রেক	Imārjēnsi brēka
জরুরি অবস্থা	Jaruri abasthā
উত্থান	Ut'thāna
নিষ্ক্রমণ করা	Niṣkramaṇa karā
পান্না	Pānnā
emcee	Emcee
আদিম	Ādima
ভ্রূণ	Bhrūṇa
ঝামেলায় জড়ান	Jhāmēlāẏa jaṛāna
সূচিকর্ম	Sūcikarma
অলঙ্কৃত করা	Alaṅkr̥ta karā
আলিঙ্গন	Āliṅgana
এমবসড	Ēmabasaḍa
খোদাই করা	Khōdā'i karā
মূর্ত করা	Mūrta karā
প্রতিমূর্তি	Pratimūrti
প্রতীক	Pratīka
উত্সব করা	Utsaba karā
embittered	Embittered
তিক্ত করা	Tikta karā
embezzler	Embezzler
আত্মসাৎ	Ātmasāṯ
আত্মসাৎ করা	Ātmasāṯ karā
জ্বলন্ত অঙ্গার	Jbalanta aṅgāra
ভূষণ	Bhūṣaṇa
অলঙ্কৃত করা	Alaṅkr̥ta karā
শোয়ান	Śōẏāna
embattled	Embattled
দূতাবাস	Dūtābāsa
বিমূঢ়তা	Bimūṛhatā
embarrassingly	Embarrassingly
হতবুদ্ধিকর	Hatabud'dhikara
অপ্রস্তুত	Aprastuta
বিব্রত করা	Bibrata karā
পোতারূঢ করা	Pōtārūḍha karā
নিষেধাজ্ঞা	Niṣēdhājñā
বাঁধ	Bām̐dha
সুবাসিত করা	Subāsita karā
বন্ধনমুক্তি	Bandhanamukti
emancipated	Emancipated
মুক্ত করা	Mukta karā
নি: সৃত হত্তয়া	Ni: Sr̥ta hattaẏā
ই - মেইল	I - mē'ila
কৃশ	Kr̥śa
' ই.এম.	' I.Ēma.
পরী	Parī
অধরা	Adharā
পালান	Pālāna
স্পষ্ট করা	Spaṣṭa karā
অন্যত্র	An'yatra
অন্যথায়	An'yathāẏa
eloquently	Eloquently
বলিয়ে	Baliẏē
বাগ্মিতা	Bāgmitā
গোপনে পলায়ন	Gōpanē palāẏana
গোপনে পলায়ন করা	Gōpanē palāẏana karā
দীর্ঘায়ত	Dīrghāẏata
সম্প্রসারিত	Samprasārita
বেদারুজাতীয় বৃক্ষবিশেষ	Bēdārujātīẏa br̥kṣabiśēṣa
উপবৃত্তাকার	Upabr̥ttākāra
হরিণবিশেষ	Hariṇabiśēṣa
অভিজাত	Abhijāta
elitism	Elitism
সেরা অংশ	Sērā anśa
বর্জন	Barjana
নিষ্কাশন করা	Niṣkāśana karā
উপযুক্ত	Upayukta
বাঁছনীয়তা	Bām̐chanīẏatā
প্রকাশ করা	Prakāśa karā
বামন	Bāmana
পরী	Parī
একাদশ	Ēkādaśa
এগার	Ēgāra
লিফট	Liphaṭa
টিলা	Ṭilā
চড়ান	Caṛāna
হাতি	Hāti
উপাদান	Upādāna
প্রাথমিক স্কুল	Prāthamika skula
প্রাথমিক	Prāthamika
আধিভৌতিক	Ādhibhautika
উপাদান	Upādāna
বিষাদসঙ্গীত	Biṣādasaṅgīta
elegantly	Elegantly
মার্জিত	Mārjita
কমনীয়তা	Kamanīẏatā
ইলেকট্রনিক্স	Ilēkaṭraniksa
ইলেকট্রনিক মেইল	Ilēkaṭranika mē'ila
বৈদ্যুতিন	Baidyutina
বৈদ্যুতিন	Baidyutina
ইলেক্ট্রন	Ilēkṭrana
তড়িদ্বিশ্লেষণ	Taṛidbiślēṣaṇa
বিদ্যুদ্বাহক	Bidyudbāhaka
তড়িতাহত	Taṛitāhata
তড়িত	Taṛita
বৈদ্যুত্	Baidyut
বৈদ্যুতীকরণ করা	Baidyutīkaraṇa karā
বৈদ্যুতিক শক	Baidyutika śaka
বৈদ্যুতিক ক্ষুর	Baidyutika kṣura
বিদ্যুৎ	Bidyuṯ
তাড়িতী	Tāṛitī
বৈদ্যুতিক চেয়ার	Baidyutika cēẏāra
বৈদ্যুতিক	Baidyutika
বৈদ্যুতিক	Baidyutika
নির্বাচকমণ্ডলী	Nirbācakamaṇḍalī
নির্বাচনী কলেজ	Nirbācanī kalēja
নির্বাচনী	Nirbācanī
নির্বাচক	Nirbācaka
নির্বাচন	Nirbācana
নির্বাচিত	Nirbācita
জ্যেষ্ঠ	Jyēṣṭha
গুরুজন	Gurujana
বৃদ্ধ	Br̥d'dha
অগ্রজ	Agraja
elbowroom	Elbowroom
কনুই	Kanu'i
উল্লাস	Ullāsa
গর্বিত	Garbita
স্থিতিস্থাপকতা	Sthitisthāpakatā
স্থিতিস্থাপক	Sthitisthāpaka
চলা	Calā
বিবরণাদি	Bibaraṇādi
বিস্তারিতভাবে	Bistāritabhābē
সম্প্রসারিত	Samprasārita
সংযোজিত করা	Sanyōjita karā
নিক্ষেপ	Nikṣēpa
দূরীভূত করা	Dūrībhūta karā
উল্লাসধ্বনি	Ullāsadhbani
নির্গত করা	Nirgata karā
নয়তো	Naẏatō
আশি	Āśi
অশীতিতম	Aśītitama
অষ্টম	Aṣṭama
অষ্টদশ	Aṣṭadaśa
আঠার	Āṭhāra
আট	Āṭa
অঁ্যা	Am̐yā
egregiously	Egregiously
মর্মান্তিক	Marmāntika
আত্মম্ভরি	Ātmambhari
আত্মশ্লাঘী	Ātmaślāghī
অস্মিতা	Asmitā
অহংভাবপূর্ণ	Ahambhābapūrṇa
অহং	Ahaṁ
ডিমের খোসা	Ḍimēra khōsā
বেগুন	Bēguna
বুদ্ধিজীবী ব্যক্তি	Bud'dhijībī byakti
ডিম	Ḍima
সাম্য	Sāmya
সমমাত্রিক	Samamātrika
উদাহরণস্বরূপ	Udāharaṇasbarūpa
EFL	EFL
effusively	Effusively
নির্গমনশীল	Nirgamanaśīla
অনায়াসে	Anāẏāsē
অনায়াস	Anāẏāsa
প্রচেষ্টা	Pracēṣṭā
প্রতিকৃতি	Pratikr̥ti
দক্ষতার	Dakṣatāra
দক্ষ	Dakṣa
দক্ষতা	Dakṣatā
বুদ্বুদপূর্ণ	Budbudapūrṇa
বুজকুড়ি	Bujakuṛi
দুর্বল	Durbala
প্রভাব	Prabhāba
কার্যকারিতা	Kāryakāritā
কার্যকরীভাবে	Kāryakarībhābē
কার্যকর	Kāryakara
প্রভাব	Prabhāba
eerily	Eerily
ভুতুড়ে	Bhutuṛē
পাঁকাল	Pām̐kāla
শিক্ষাব্রতী	Śikṣābratī
শিক্ষাগতভাবে	Śikṣāgatabhābē
শিক্ষাগত	Śikṣāgata
শিক্ষা	Śikṣā
শিক্ষিত	Śikṣita
শিক্ষিত করা	Śikṣita karā
সম্পাদকীয়	Sampādakīẏa
সম্পাদক	Sampādaka
সংস্করণ	Sanskaraṇa
সম্পাদন করা	Sampādana karā
নৈতিক করা	Naitika karā
প্রাসাদ	Prāsāda
শিক্ষাদীক্ষা	Śikṣādīkṣā
ফরমান	Pharamāna
ভোজ্য	Bhōjya
ধারাল	Dhārāla
কিনারার দিকে	Kinārāra dikē
প্রান্ত	Prānta
ঘূর্ণিবায়ু	Ghūrṇibāẏu
চর্মরোগবিশেষ	Carmarōgabiśēṣa
জগদ্ব্যাপী	Jagadbyāpī
ভাবাবেশকর	Bhābābēśakara
পরমানন্দ	Paramānanda
বাস্তুতন্ত্র	Bāstutantra
অর্থনীতি	Arthanīti
খরচ বাঁচান	Kharaca bām̐cāna
অর্থনীতিবিদ	Arthanītibida
অর্থনীতি	Arthanīti
অর্থনৈতিকভাবে	Arthanaitikabhābē
মিতব্যয়ী	Mitabyaẏī
অর্থনৈতিক	Arthanaitika
বাস্তুসংস্থান	Bāstusansthāna
বাস্তব্যবিদ্যা	Bāstabyabidyā
বাস্তু-	Bāstu-
বাস্তুসংস্থানসংক্রান্ত	Bāstusansthānasaṅkrānta
অন্ধকার	Andhakāra
Eclair	Eclair
প্রতিধ্বনি	Pratidhbani
যাজকীয়	Yājakīẏa
ছিট	Chiṭa
অদ্ভুতস্বভাব	Adbhutasbabhāba
অত্যুত্সাহী	Atyutsāhī
ফোটা	Phōṭā
আবলুস	Ābalusa
ভাটা	Bhāṭā
যে আড়ি পেতে শুনে	Yē āṛi pētē śunē
আড়ি পেতে শোনা	Āṛi pētē śōnā
ঘরের ছাঁইচ	Gharēra chām̐ica
খাবারের দোকান	Khābārēra dōkāna
ভক্ষক	Bhakṣaka
ভুক্ত	Bhukta
খাওয়া	Khā'ōẏā
চিন্তাভাবনাহীন	Cintābhābanāhīna
আরাম-কেদারা	Ārāma-kēdārā
সহজ	Sahaja
পূর্বদিকে	Pūrbadikē
পূর্বদিকে	Pūrbadikē
প্রাচ্যবাসী	Prācyabāsī
পূর্ব	Pūrba
পুবাল বাতাস	Pubāla bātāsa
ইস্টার ডিম	Isṭāra ḍima
স্টার	Sṭāra
Eastbound	Eastbound
পূর্ব	Pūrba
সহজে	Sahajē
চিত্রফলক	Citraphalaka
আরাম	Ārāma
খলি	Khali
মর	Mara
কেঁচো	Kēm̐cō
earthshaking	Earthshaking
ভূমিকম্প	Bhūmikampa
পার্থিব	Pārthiba
earthiness	Earthiness
পৃথিবী	Pr̥thibī
পৃথিবী	Pr̥thibī
earsplitting	Earsplitting
শুনিতে পাইবার মত দূরত্ব	Śunitē pā'ibāra mata dūratba
মাকড়ি	Mākaṛi
earplug	Earplug
হেডফোন	Hēḍaphōna
উপার্জন	Upārjana
ব্যগ্রতা	Byagratā
আন্তরিকভাবে	Āntarikabhābē
আন্তরিক	Āntarika
উপার্জন করা	Upārjana karā
টুপির কান	Ṭupira kāna
পরিচায়ক চিহ্ন	Paricāẏaka cihna
গোড়ার দিকে	Gōṛāra dikē
কানের লতি	Kānēra lati
কানের পরদা	Kānēra paradā
কর্ণশূল	Karṇaśūla
কান	Kāna
তীক্ষ্ণদৃষ্টি	Tīkṣṇadr̥ṣṭi
গল	Gala
ব্যস্ততা	Byastatā
সাগ্রহে	Sāgrahē
আগ্রহী	Āgrahī
পরস্পর	Paraspara
gyroscope	Gyroscope
চক্রগতি	Cakragati
চক্রাকারে ঘোরা	Cakrākārē ghōrā
বেদে	Bēdē
শঠতা	Śaṭhatā
স্ত্রীরোগবিদ্যা	Strīrōgabidyā
স্ত্রীরোগবিশারদ	Strīrōgabiśārada
স্ত্রীরোগবিদ্যা-সংক্রান্ত	Strīrōgabidyā-saṅkrānta
ব্যায়াম	Byāẏāma
পালোয়ান	Pālōẏāna
আখড়া	Ākhaṛā
জিম	Jima
মদ্যপ	Madyapa
মদ্যপানোত্সব	Madyapānōtsaba
লোক	Lōka
কণ্ঠ্যবর্ণ	Kaṇṭhyabarṇa
নর্দমা	Nardamā
সাহসী	Sāhasī
নাড়িভুঁড়ি	Nāṛibhum̐ṛi
অন্ত্র	Antra
দমকা	Damakā
ঔত্সুক্য	Autsukya
ঝাপটা	Jhāpaṭā
gushy	Gushy
প্রবলভাবে নি: সৃত পদার্থ	Prabalabhābē ni: Sr̥ta padārtha
প্রবাহ	Prabāha
গুরু	Guru
কবল	Kabala
কচ্কচি	Kackaci
কামানের পাল্লা	Kāmānēra pāllā
gunrunning	Gunrunning
gunrunner	Gunrunner
বারূদ	Bārūda
gunpoint	Gunpoint
gunnysack	Gunnysack
গোলন্দাজ	Gōlandāja
বন্দুকধারী সৈনিক	Bandukadhārī sainika
চটচটে বা তরল পদার্থ	Caṭacaṭē bā tarala padārtha
gung- ইছ	Gung- icha
কামান দাগা	Kāmāna dāgā
কামান-বাহী পোত	Kāmāna-bāhī pōta
বন্দুক	Banduka
বুঝ	Bujha
আঠাযুক্ত	Āṭhāyukta
gumdrop	Gumdrop
Gumbo	Gumbo
আঠা	Āṭhā
ঢোক	Ḍhōka
বড়ো ছোরা	Baṛō chōrā
অতিসরল	Atisarala
gullibility	Gullibility
গলনালী	Galanālī
জলকুক্কুট	Jalakukkuṭa
উপসাগর	Upasāgara
গিরিখাত	Girikhāta
গিটার	Giṭāra
গিটার	Giṭāra
ভান	Bhāna
গিনিপিগ	Ginipiga
দোষী	Dōṣī
guiltily	Guiltily
কলুষ	Kaluṣa
শিরছেদনার্থ যন্ত্রবিশেষ	Śirachēdanārtha yantrabiśēṣa
সরল	Sarala
ছলনা	Chalanā
পৌরসভা	Paurasabhā
নির্দেশিকা	Nirdēśikā
গাইডলাইন	Gā'iḍalā'ina
অধ্যক্ষ	Adhyakṣa
পথপঁজি	Pathapam̐ji
কৌশল	Kauśala
নির্দেশিকা পরামর্শদাতা	Nirdēśikā parāmarśadātā
পথপ্রদর্শন	Pathapradarśana
অট্টহাসি	Aṭṭahāsi
অর্থহীন অট্টহাস	Arthahīna aṭṭahāsa
অতিথি	Atithi
অনুমানপ্রসূত মত	Anumānaprasūta mata
আন্দাজি হিসেব	Āndāji hisēba
অনুমান	Anumāna
গরিলা	Garilā
শাসক-সংক্রান্ত	Śāsaka-saṅkrānta
সিঁড়ির পার্শ্বস্থ রেলিং	Sim̐ṛira pārśbastha rēliṁ
মানুষের ব্যক্তিগত শুভসাধক দেবদূত	Mānuṣēra byaktigata śubhasādhaka dēbadūta
অভিভাবক	Abhibhābaka
guardedly	Guardedly
সুরক্ষিত	Surakṣita
পাহারা	Pāhārā
জামিন	Jāmina
জামিনদার	Jāminadāra
জামিন	Jāmina
guacamole	Guacamole
জি - স্ট্রিং	Ji - sṭriṁ
ঘোঁৎ ঘোঁৎ	Ghōm̐ṯ ghōm̐ṯ
grungy	Grungy
গ্রুঙ্গ	Gruṅga
বদরাগী	Badarāgī
অভিযোগ	Abhiyōga
মাইয়াডারে বাঁচাও	Mā'iẏāḍārē bām̐cā'ō
বিষাদময়	Biṣādamaẏa
ঘৃণ্য	Ghr̥ṇya
কঠোর	Kaṭhōra
জাউ	Jā'u
কৃপণ	Kr̥paṇa
দ্বেষ	Dbēṣa
অপরিচ্ছন্ন	Aparicchanna
কীড়া	Kīṛā
বৃদ্ধি	Br̥d'dhi
ধাড়ী	Dhāṛī
পূর্ণবয়স্ক	Pūrṇabaẏaska
গজরানি	Gajarāni
ক্রমবর্ধমান যন্ত্রনা	Kramabardhamāna yantranā
চারা	Cārā
হত্তয়া	Hattaẏā
পদলেহন	Padalēhana
উদ্যান	Udyāna
অনাদর	Anādara
গোষ্ঠী	Gōṣṭhī
Groupie	Groupie
গ্রুপ	Grupa
বনিয়াদ	Baniẏāda
groundswell	Groundswell
তলানি	Talāni
স্থল নিয়ম	Sthala niẏama
অকারণ	Akāraṇa
ভিত্তিহীন	Bhittihīna
ভিত্তি	Bhitti
Groundhog দিন	Groundhog dina
Groundhog	Groundhog
একতলা	Ēkatalā
স্থল ক্রু	Sthala kru
স্থল	Sthala
খিট্খিটে	Khiṭkhiṭē
অসন্তোষ প্রকাশ করা	Asantōṣa prakāśa karā
গুহা	Guhā
অদ্ভুত	Adbhuta
প্রবলভাবে	Prabalabhābē
স্থূল	Sthūla
অনুভব করা	Anubhaba karā
খাঁজকাটা	Khām̐jakāṭā
খাঁজ	Khām̐ja
গ্রুমিং	Grumiṁ
বর	Bara
কুঁচকি	Kum̐caki
টলায়মান	Ṭalāẏamāna
মুদি দোকান	Mudi dōkāna
মুদিখানা	Mudikhānā
মুদীখানার পণ্যদ্রব্য	Mudīkhānāra paṇyadrabya
মুদি	Mudi
গাঁ	Gām̐
ছাইরঙা ভালুক	Chā'iraṅā bhāluka
বালুকাময়	Bālukāmaẏa
মোটাভাবে চূর্ণিত শস্য	Mōṭābhābē cūrṇita śasya
কঙ্কর	Kaṅkara
তরুণাস্থি	Taruṇāsthi
ভয়ানক	Bhaẏānaka
gripping	Gripping
আঁকড়ান	Ām̐kaṛāna
দৃঢ়মুষ্টি	Dr̥ṛhamuṣṭi
পরদেশী	Paradēśī
শান	Śāna
পেষকদন্ত	Pēṣakadanta
চূর্ণনশব্দ	Cūrṇanaśabda
কষ্টহাসি	Kaṣṭahāsi
নোংরা	Nōnrā
ক্ষমাহীনভাবে	Kṣamāhīnabhābē
ময়লা	Maẏalā
ভেংচি	Bhēn̄ci
ভয়ানক	Bhaẏānaka
ভাজাভুজি	Bhājābhuji
দু: খজনক	Du: Khajanaka
শোক করা	Śōka karā
নালিশের কারণ	Nāliśēra kāraṇa
বিষাদ	Biṣāda
জট	Jaṭa
জাফরি	Jāphari
তাত্তয়া	Tāttaẏā
গ্রিড	Griḍa
ডালকুত্তা	Ḍālakuttā
হয়েছি	Haẏēchi
বোমা	Bōmā
ভূত	Bhūta
যূথচর	Yūthacara
শুভেচ্ছা	Śubhēcchā
অভিবাদন কার্ড	Abhibādana kārḍa
অভিবাদন	Abhibādana
অভিবাদন জানান	Abhibādana jānāna
সবুজ শাকসবজি	Sabuja śākasabaji
হরিতাভ	Haritābha
গ্রিনহাউজ এফেক্ট	Grinahā'uja ēphēkṭa
গ্রিনহাউজ	Grinahā'uja
বালক	Bālaka
শ্যামলিমা	Śyāmalimā
সবুজ কার্ড	Sabuja kārḍa
সবুজ শিম	Sabuja śima
আমেরিকার পত্রমুদ্রা	Āmērikāra patramudrā
সবুজ	Sabuja
গ্রিক	Grika
অর্থগৃধ্নু	Arthagr̥dhnu
সাগ্রহে	Sāgrahē
ক্ষুধা	Kṣudhā
মহিমা	Mahimā
অতিশয়	Atiśaẏa
প্রপৌত্র	Prapautra
মহান - পিতামহ	Mahāna - pitāmaha
মহান - দাদীর	Mahāna - dādīra
মহান - পিতামহ	Mahāna - pitāmaha
মহান - নাতনী	Mahāna - nātanī
মহান - নাতি	Mahāna - nāti
গ্রেট্ ব্রিেন	Grēṭ briēna
মহান	Mahāna
চর্বিযুক্ত	Carbiyukta
চর্বি লাগানো	Carbi lāgānō
আচড়	Ācaṛa
মগজ	Magaja
ষৎ ধূসর	Ṣaṯ dhūsara
ধূসর	Dhūsara
রসা	Rasā
মাধ্যাকর্ষণ	Mādhyākarṣaṇa
মহাকর্ষ	Mahākarṣa
ঝুঁকিয়ে পড়া	Jhum̐kiẏē paṛā
কারবালা	Kārabālā
সমাধিস্তম্ভ	Samādhistambha
গুরুত্বসহকারে	Gurutbasahakārē
নুড়ি	Nuṛi
সমাধি	Samādhi
আনুতোষিক	Ānutōṣika
ভিত্তিহীন	Bhittihīna
কৃতজ্ঞতা	Kr̥tajñatā
বিনামূল্যে	Bināmūlyē
কর্কশ	Karkaśa
gratifying	Gratifying
পরিতৃপ্ত করা	Paritr̥pta karā
পরিতৃপ্তি	Paritr̥pti
আঁচড়া	Ām̐caṛā
কৃতজ্ঞচিত্তে	Kr̥tajñacittē
কৃতজ্ঞ	Kr̥tajña
ঝাঁঝরি	Jhām̐jhari
শ্যামল	Śyāmala
ঘাস শিকড়	Ghāsa śikaṛa
ঘাস শিকড়	Ghāsa śikaṛa
কেদার	Kēdāra
ফড়িং	Phaṛiṁ
ঘাস	Ghāsa
সুদৃঢ়	Sudr̥ṛha
উপলব্ধি	Upalabdhi
কুস্তি করা	Kusti karā
কৃষ্ণসীস নামক ধাতু	Kr̥ṣṇasīsa nāmaka dhātu
গ্রাফিক্স	Grāphiksa
graphically	Graphically
গ্রাফিক	Grāphika
চিত্রলেখ	Citralēkha
Grapevine	Grapevine
জাম্বুরা	Jāmburā
দ্রাক্ষা	Drākṣā
কণিকা	Kaṇikā
কণিকাকার	Kaṇikākāra
ঝুরা	Jhurā
মঞ্জুর	Mañjura
অনুদান	Anudāna
granola	Granola
বৃদ্ধা	Br̥d'dhā
গ্র্যানিত্শিলা	Gryānitśilā
সর্বোমোট	Sarbōmōṭa
লোকদেখান	Lōkadēkhāna
নাতি	Nāti
গ্র্যান্ড স্লাম	Gryānḍa slāma
গ্র্যান্ড প্রিক্স	Gryānḍa priksa
পিয়ানো	Piẏānō
পিতামহ	Pitāmaha
মাতামহ	Mātāmaha
নানী	Nānī
ঠাকুরমা	Ṭhākuramā
grandly	Grandly
গ্র্যান্ড জুরি	Gryānḍa juri
সুবিশাল	Subiśāla
পিতামহ ঘড়ি	Pitāmaha ghaṛi
পিতামহ	Pitāmaha
জাঁকজমক	Jām̐kajamaka
নাতনী	Nātanī
মাতামহ	Mātāmaha
নাতি	Nāti
নাতি	Nāti
ব্যাকরণগত	Byākaraṇagata
মহীয়ান	Mahīẏāna
ব্যাকরণগতভাবে	Byākaraṇagatabhābē
গ্র্যামি	Gryāmi
প্রাচীন ভার্ষা শিক্ষার বিদ্যালয়	Prācīna bhārṣā śikṣāra bidyālaẏa
ব্যাকরণ	Byākaraṇa
গ্রাম	Grāma
দানাদার	Dānādāra
শস্য	Śasya
ঘুস	Ghusa
দেত্তয়ালের ছবি	Dēttaẏālēra chabi
স্নাতকের	Snātakēra
স্নাতক স্কুল	Snātaka skula
স্নাতক	Snātaka
ধীরে ধীরে	Dhīrē dhīrē
ক্রমান্বয়িক	Kramānbaẏika
grad স্কুল	Grad skula
নতিমাত্রা	Natimātrā
গ্রেড স্কুল	Grēḍa skula
grader	Grader
গ্রেড পয়েন্ট গড়	Grēḍa paẏēnṭa gaṛa
শ্রেণী	Śrēṇī
ক্রমবিন্যাস	Kramabin'yāsa
Grad	Grad
বদান্যতা	Badān'yatā
অনুগ্রহপূর্বক	Anugrahapūrbaka
কৃপাময়	Kr̥pāmaẏa
সৌন্দর্য	Saundarya
gracefully	Gracefully
সুতনু	Sutanu
অনুগ্রহ	Anugraha
দখল	Dakhala
জিপিএ	Jipi'ē
গাউন	Gā'una
গভর্নর	Gabharnara
রাজ্যপাল	Rājyapāla
সরকারি	Sarakāri
সরকার	Sarakāra
শাসন ​​করা	Śāsana ​​karā
গেঁটেবাত	Gēm̐ṭēbāta
খাইয়ে লোক	Khā'iẏē lōka
লাউ	Lā'u
গোলাস	Gōlāsa
উপড়াইয়া ফেলা	Upaṛā'iẏā phēlā
অর্জিত	Arjita
অতি	Ati
পেয়েছেন	Pēẏēchēna
পরচর্চা	Paracarcā
গসপেল গান	Gasapēla gāna
ধর্মবাণী	Dharmabāṇī
ধর্মবাণী	Dharmabāṇī
শিশু-হংসী	Śiśu-hansī
ভগবন্	Bhagaban
রক্তাক্ত	Raktākta
বনমানুষ	Banamānuṣa
gorgeously	Gorgeously
টকটকে	Ṭakaṭakē
ঘাট	Ghāṭa
রক্ত	Rakta
খোঁড়া	Khōm̐ṛā
টেস্ট	Ṭēsṭa
হংসী বাধা বিপত্তি	Hansī bādhā bipatti
হংসী	Hansī
গণ্ডমূর্খ	Gaṇḍamūrkha
বোকা	Bōkā
গুবলেট বন্ধ	Gubalēṭa bandha
বোকা লোক	Bōkā lōka
ভাবালু	Bhābālu
নেহাৎ ভালমানুষ	Nēhāṯ bhālamānuṣa
নেহাৎ ভালমানুষ	Nēhāṯ bhālamānuṣa
মঙ্গলকামনা	Maṅgalakāmanā
অনিনি্দতচরিত্র	Aninidatacaritra
মাল	Māla
ভাল বয়সী ছেলে	Bhāla baẏasī chēlē
ধার্মিকতা	Dhārmikatā
সত্স্বভাব	Satsbabhāba
সৌম্যদর্শন	Saumyadarśana
গুডিজ	Guḍija
খোশমেজাজী	Khōśamējājī
ভাল লোক	Bhāla lōka
গুড ফ্রাইডে	Guḍa phrā'iḍē
ভাল - জন্য - কিছুই	Bhāla - jan'ya - kichu'i
ভাল সম্ভাষণ	Bhāla sambhāṣaṇa
গুড বুক	Guḍa buka
ভাল	Bhāla
সস্তা ভাবালুতা	Sastā bhābālutā
প্রমেহ	Pramēha
করত	Karata
ঘণ্টা	Ghaṇṭā
মৃত ব্যক্তি	Mr̥ta byakti
সর্বস্বান্ত	Sarbasbānta
গন্ডোলা	Ganḍōlā
বিস্ময়সূচক অব্যয়	Bismaẏasūcaka abyaẏa
গল্ফ খেলোয়াড়	Galpha khēlōẏāṛa
গলফ কোর্স	Galapha kōrsa
গলফ ক্লাব	Galapha klāba
গলফ বল	Galapha bala
গলফ	Galapha
ফ্যাশন অন্বেষণ	Phyāśana anbēṣaṇa
সোনার খনি	Sōnāra khani
স্বর্ণ পদকপ্রাপ্ত	Sbarṇa padakaprāpta
স্বর্ণ পদক	Sbarṇa padaka
গোল্ডফিশ	Gōlḍaphiśa
সুবর্ণ বার্ষিকী	Subarṇa bārṣikī
সুবর্ণ	Subarṇa
স্বর্ণের খনক	Sbarṇēra khanaka
স্বর্ণ	Sbarṇa
ঘটনাসমূহ	Ghaṭanāsamūha
যাওয়া - ওভার	Yā'ōẏā - ōbhāra
চালু	Cālu
রক্ষাকর চশমাবিশেষ	Rakṣākara caśamābiśēṣa
উদ্যোগী লোক	Udyōgī lōka
Gofer	Gofer
সফলতা	Saphalatā
ধর্মপিতা	Dharmapitā
ধর্মমাতা	Dharmamātā
ধার্মিক	Dhārmika
দেবতুল্য	Dēbatulya
নাস্তিক	Nāstika
godforsaken	Godforsaken
ধর্মপিতা	Dharmapitā
দেবী	Dēbī
goddamned	Goddamned
goddamn	Goddamn
godchildren	Godchildren
ধর্মসন্তান	Dharmasantāna
বেয়াড়া	Bēẏāṛā
দেবতা	Dēbatā
দেবতা	Dēbatā
পাল্কি	Pālki
gobs	Gobs
অপদেবতা	Apadēbatā
পানপাত্র	Pānapātra
সালিস	Sālisa
gobbledygook	Gobbledygook
গরগর শব্দ	Garagara śabda
নাবিক	Nābika
নুর	Nura
ছাগল	Chāgala
goalpost	Goalpost
গোলরক্ষক	Gōlarakṣaka
গোলরক্ষক	Gōlarakṣaka
লক্ষ্য	Lakṣya
উদ্যোগী	Udyōgī
অঙ্কুশ	Aṅkuśa
যাওয়া	Yā'ōẏā
GNP	GNP
সূক্ত	Sūkta
gnawing	Gnawing
চিবান	Cibāna
মশা	Maśā
কড়্মড়	Kaṛmaṛa
একগুঁয়ে	Ēkagum̐ẏē
জেদী	Jēdī
GMAT	GMAT
গ্লিসারিন	Glisārina
অতিভোজন	Atibhōjana
পেটুক	Pēṭuka
গোগ্রাসে গেলা	Gōgrāsē gēlā
glumly	Glumly
বিষাদগ্রস্ত	Biṣādagrasta
আঠা	Āṭhā
গ্লুকোজ	Glukōja
জোনাকি	Jōnāki
glowingly	Glowingly
প্রদীপ্ত	Pradīpta
glowering	Glowering
একদৃষ্টিতে তাকান	Ēkadr̥ṣṭitē tākāna
ভাস	Bhāsa
ড্যাশবক্স	Ḍyāśabaksa
দস্তানা	Dastānā
চকচকে	Cakacakē
টিপ্পনি	Ṭippani
টীকাটিপ্পনী	Ṭīkāṭippanī
গৌরব	Gauraba
gloriously	Gloriously
প্রসিদ্ধ	Prasid'dha
কীর্তন করা	Kīrtana karā
মহিমান্বিত	Mahimānbita
কীর্তন	Kīrtana
আঁধার	Ām̐dhāra
হতাশা	Hatāśā
হতাশায়	Hatāśāẏa
বিষাদ	Biṣāda
বটিকা	Baṭikā
গোল	Gōla
globetrotter	Globetrotter
পৃথিবী	Pr̥thibī
বিশ্বব্যাপী	Biśbabyāpī
বিশ্বব্যাপী	Biśbabyāpī
glob	Glob
আগ্রহসহকারে দেখা	Āgrahasahakārē dēkhā
glitzy	Glitzy
চাকচিক্য	Cākacikya
ঝক্ঝকে	Jhakjhakē
চিক্চিক	Cikcika
সামান্য ত্রুটি	Sāmān'ya truṭi
ঝলমল করা	Jhalamala karā
জ্বলজ্বল করা	Jbalajbala karā
আভাস	Ābhāsa
আভাস	Ābhāsa
এনজির্নহীন বিমান	Ēnajirnahīna bimāna
পিছলে পড়া	Pichalē paṛā
শতমুখে	Śatamukhē
শতমুখ	Śatamukha
gleefully	Gleefully
সানন্দ	Sānanda
উল্লাস	Ullāsa
উঁচ্ছবৃত্তি	Um̐cchabr̥tti
gleaming	Gleaming
কিরণ	Kiraṇa
মাতাল	Mātāla
চকচকানি	Cakacakāni
কাচিক	Kācika
কাচপাত্র	Kācapātra
চশমা	Caśamā
গ্লাস সিলিং	Glāsa siliṁ
কাচ	Kāca
জ্বলজ্বলে	Jbalajbalē
একদৃষ্টি	Ēkadr̥ṣṭi
গ্রন্থিময়	Granthimaẏa
গণ্ড	Gaṇḍa
চাহনি	Cāhani
ইন্দ্রজাল	Indrajāla
glamorously	Glamorously
চাকচিক্যময়	Cākacikyamaẏa
চটকদার	Caṭakadāra
সানন্দে	Sānandē
প্রাচীন রোমের মল্লযোদ্ধা	Prācīna rōmēra mallayōd'dhā
ডাঙ্গা	Ḍāṅgā
আনন্দিত	Ānandita
হিমবাহ	Himabāha
জমাট বাঁধা	Jamāṭa bām̐dhā
কণ্ঠ	Kaṇṭha
Gizmo	Gizmo
প্রদত্ত নাম	Pradatta nāma
প্রদত্ত	Pradatta
giveaway	Giveaway
আপোষ	Āpōṣa
দেত্তয়া	Dēttaẏā
সারকথা	Sārakathā
ঘের	Ghēra
গার্ল স্কাউট	Gārla skā'uṭa
গার্ল স্কাউট	Gārla skā'uṭa
বান্ধবী	Bāndhabī
মেয়ে	Mēẏē
ঘের	Ghēra
বেষ্টক	Bēṣṭaka
জিরাফ	Jirāpha
ছাতা	Chātā
সাবধানে	Sābadhānē
জিনজার ব্রেড	Jinajāra brēḍa
আদা-মিশ্রিত পানীয়বিশেষ	Ādā-miśrita pānīẏabiśēṣa
আদা	Ādā
জিন	Jina
প্রতারণামূলক	Pratāraṇāmūlaka
প্রতারণাপূর্ণ কৌশল	Pratāraṇāpūrṇa kauśala
ফুলকা	Phulakā
সমবায় সঙ্ঘ	Samabāẏa saṅgha
মুখ চাপিয়া হাসা	Mukha cāpiẏā hāsā
রাক্ষুসে	Rākṣusē
গিগাবাইট	Gigābā'iṭa
কোঁচ	Kōm̐ca
প্রতিভাধর	Pratibhādhara
উপহার সার্টিফিকেট	Upahāra sārṭiphikēṭa
উপহার	Upahāra
ঘূর্ণায়মান	Ghūrṇāẏamāna
পাখির মাংস রাধবার আগে পাখির শরীরের যে সমস্ত ভক্ষণযোগ্য অঙ্গ আলাদা করে নেওয়া হয়	Pākhira mānsa rādhabāra āgē pākhira śarīrēra yē samasta bhakṣaṇayōgya aṅga ālādā karē nē'ōẏā haẏa
উপহাস	Upahāsa
অর্থহীন কথা	Arthahīna kathā
দৈত্য	Daitya
আমলাতান্ত্রিক	Āmalātāntrika
পৈশাচিক	Paiśācika
পিশাচ	Piśāca
ঘোস্টরাইটার	Ghōsṭarā'iṭāra
প্রেতপুরী	Prētapurī
অশরীরী	Aśarīrī
প্রেতাত্মা	Prētātmā
শহরে ইন্থর্দিপাড়া	Śaharē inthardipāṛā
ভয়ানক	Bhaẏānaka
উষ্ণপ্রস্রবণ	Uṣṇaprasrabaṇa
GetUp	GetUp
পুরাতন বন্ধুবান্ধব প্রভৃতির পুনর্মিলন	Purātana bandhubāndhaba prabhr̥tira punarmilana
getaway	Getaway
পাওয়া	Pā'ōẏā
অঙ্গভঙ্গি	Aṅgabhaṅgi
ঠারা	Ṭhārā
গর্ভকাল	Garbhakāla
ক্রিয়াবাচক বিশেষ্যপদ	Kriẏābācaka biśēṣyapada
gerrymandering	Gerrymandering
কূটকৌশল	Kūṭakauśala
অঙ্কুর	Aṅkura
অঙ্কুরিত করা	Aṅkurita karā
জার্মান মেষপালক	Jārmāna mēṣapālaka
জার্মান হাম	Jārmāna hāma
জার্মান	Jārmāna
জীবাণু	Jībāṇu
জেরিয়াত্রিক্স	Jēriẏātriksa
বয়স্ক	Baẏaska
আকৃতির ফল দেয়	Ākr̥tira phala dēẏa
জ্যামিতি	Jyāmiti
জ্যামিতিক	Jyāmitika
জ্যামিতিক	Jyāmitika
ভূতত্ত্ব	Bhūtattba
ভূবিজ্ঞানী	Bhūbijñānī
ভূতাত্ত্বিক	Bhūtāttbika
ভূগোল	Bhūgōla
ভৌগোলিক	Bhaugōlika
ভৌগোলিক	Bhaugōlika
ভৌগোলিক	Bhaugōlika
মহাজাতি	Mahājāti
সত্যিকারভাবে	Satyikārabhābē
অকৃত্রিম	Akr̥trima
গড় হত্তয়া	Gaṛa hattaẏā
ভদ্রসম্প্রদায়	Bhadrasampradāẏa
gentrification	Gentrification
আস্তে	Āstē
নম্রতা	Namratā
ভদ্রলোক	Bhadralōka
মৃদু	Mr̥du
ভদ্রসমাজ	Bhadrasamāja
গোষ্ঠীভুক্ত	Gōṣṭhībhukta
সুশীল	Suśīla
সজ্জন	Sajjana
রীতি	Rīti
গণহত্যা	Gaṇahatyā
প্রতিভা	Pratibhā
জননেনি্দ্রয়	Jananēnidraẏa
উপস্থ	Upastha
বংশ সম্বন্ধীয়	Banśa sambandhīẏa
সদয়	Sadaẏa
সুপ্রজননবিদ্যা	Suprajananabidyā
প্রজনন বিদ্যা বিশেষজ্ঞ	Prajanana bidyā biśēṣajña
জেনেটিক ইঞ্জিনিয়ারিং	Jēnēṭika iñjiniẏāriṁ
জেনেটিকালি	Jēnēṭikāli
জেনেটিক	Jēnēṭika
জনন	Janana
উদারভাবে	Udārabhābē
উদার	Udāra
বদান্যতা	Badān'yatā
জেনেরিক	Jēnērika
জাতিবাচক	Jātibācaka
উত্পাদক	Utpādaka
জেনারেশন এক্স	Jēnārēśana ēksa
প্রজন্মের ফাঁক	Prajanmēra phām̐ka
প্রজন্ম	Prajanma
জেনারেট	Jēnārēṭa
সাধারণ দোকান	Sādhāraṇa dōkāna
সাধারণত	Sādhāraṇata
সাধারণ	Sādhāraṇa
বিশ্বজনীন করা	Biśbajanīna karā
সামান্যীকরণ	Sāmān'yīkaraṇa
সাধারণ নির্বাচনে	Sādhāraṇa nirbācanē
সাধারণ অবেদনিক	Sādhāraṇa abēdanika
সাধারণ	Sādhāraṇa
গণ	Gaṇa
বংশতালিকা	Banśatālikā
কুলাচার্য	Kulācārya
কুলুজি সংক্রান্ত	Kuluji saṅkrānta
জিন	Jina
লিঙ্গ	Liṅga
জেনারেল	Jēnārēla
মিথুনরাশি	Mithunarāśi
মণি	Maṇi
খোজাকরণ	Khōjākaraṇa
সিরিশ-আঠা	Siriśa-āṭhā
জেল	Jēla
জাপানীবাইজি	Jāpānībā'iji
লোক	Lōka
বাড়িয়ে	Bāṛiẏē
geeky	Geeky
গুরু	Guru
ঘোড়া	Ghōṛā
GED	GED
gearshift	Gearshift
গিয়ার্	Giẏār
গেজেট	Gējēṭa
হরিণ	Hariṇa
গাজেবো	Gājēbō
ঠাউর	Ṭhā'ura
গে	Gē
লাজুক	Lājuka
জবুথবু লোক	Jabuthabu lōka
সভাপতির হাতুড়ি	Sabhāpatira hātuṛi
দিয়েছেন	Diẏēchēna
গজ	Gaja
সামরিক শাস্তিবিশেষ	Sāmarika śāstibiśēṣa
কৃশ	Kr̥śa
হিসাব করার নিয়ম	Hisāba karāra niẏama
হাসিখুশি	Hāsikhuśi
আনাড়ি	Ānāṛi
জমায়েত	Jamāẏēta
জমা	Jamā
প্রবেশপথ	Prabēśapatha
Gatecrasher	Gatecrasher
গেট	Gēṭa
গ্যাসের কারখানা	Gyāsēra kārakhānā
উত্তম পানভোজনসংক্রান্ত	Uttama pānabhōjanasaṅkrānta
পাচক	Pācaka
গ্যাসীয়	Gyāsīẏa
গ্যাস স্টেশন	Gyāsa sṭēśana
এক্সিলেটর	Ēksilēṭara
খাবি	Khābi
পেট্রল	Pēṭrala
বিষবাষ্পপ্রতিরোধী মুখোশ	Biṣabāṣpapratirōdhī mukhōśa
gasket	Gasket
গভীর ক্ষত	Gabhīra kṣata
বায়বীয়	Bāẏabīẏa
গ্যাস চেম্বারের	Gyāsa cēmbārēra
গ্যাস	Gyāsa
গাটার	Gāṭāra
ফচকে	Phacakē
সৈন্য সরবরাহ করা	Sain'ya sarabarāha karā
চিলেকোঠা	Cilēkōṭhā
আভরণ	Ābharaṇa
তামড়ি	Tāmaṛi
চেল	Cēla
রসুন	Rasuna
মাল্য	Mālya
চটকদার	Caṭakadāra
মর্কট	Markaṭa
কুলকুচা	Kulakucā
প্রকাণ্ড	Prakāṇḍa
উদ্যানপালন	Udyānapālana
মালী	Mālī
বাগান	Bāgāna
বিকৃত হয়ে	Bikr̥ta haẏē
আবর্জনা মানুষ	Ābarjanā mānuṣa
গার্বেজ করতে পারেন	Gārbēja karatē pārēna
আবর্জনা	Ābarjanā
পোশাক	Pōśāka
গ্যারেজ বিক্রয়	Gyārēja bikraẏa
গ্যারেজ	Gyārēja
জৃম্ভমান	Jr̥mbhamāna
মুখব্যাদান	Mukhabyādāna
ফাঁক	Phām̐ka
চলাফেরার পথ	Calāphērāra patha
গুণ্ডা	Guṇḍā
পচা ঘা	Pacā ghā
gangplank	Gangplank
ডিগ্ভিগে	Ḍigbhigē
gangland	Gangland
দল	Dala
রাজহাঁস	Rājahām̐sa
স্বরগ্রাম	Sbaragrāma
গেম শো	Gēma śō
গেম	Gēma
খেলার পরিকল্পনা	Khēlāra parikalpanā
খেলা	Khēlā
জুয়া	Juẏā
জুয়াড়ি	Juẏāṛi
জুয়া	Juẏā
Gambit	Gambit
রাংঝালাই করা	Rān̄jhālā'i karā
galoshes	Galoshes
প্রচুর পরিমাণে	Pracura parimāṇē
ফাঁসিকাঠ	Phām̐sikāṭha
স্বচ্ছন্দধাবন	Sbacchandadhābana
পয়সের পাঁচ সের	Paẏasēra pām̐ca sēra
ছিনালি করা	Chināli karā
জাহাজের	Jāhājēra
গ্যালারি	Gyālāri
পিত্তকোষ	Pittakōṣa
নাগরালি	Nāgarāli
প্রাণপনে	Prāṇapanē
প্রেমপূর্ণ	Prēmapūrṇa
পিত্ত	Pitta
বাত্যা	Bātyā
ছায়াপথ	Chāẏāpatha
ছায়াপথসংক্রান্ত	Chāẏāpathasaṅkrānta
আনুষ্ঠানিক	Ānuṣṭhānika
মেয়ে .	Mēẏē.
মেয়ে	Mēẏē
গেইট	Gē'iṭa
লাভ	Lābha
ফূর্তিতে	Phūrtitē
আন্নদ	Ānnada
ঠাট্টা অর্ডার	Ṭhāṭṭā arḍāra
ঝাঁক	Jhām̐ka
ঠাট্টা	Ṭhāṭṭā
অসমীচীন কাজ	Asamīcīna kāja
গ্যাজেট	Gyājēṭa
বাড়ির ত্রিকোণ ধার	Bāṛira trikōṇa dhāra
কইয়ে	Ka'iẏē
FYI	FYI
ঝাপসা	Jhāpasā
মিহি গুঁড়া	Mihi gum̐ṛā
আধুনিক	Ādhunika
কাল ভবিষ্যত	Kāla bhabiṣyata
ভবিষ্যৎ	Bhabiṣyaṯ
একবোরে	Ēkabōrē
বৃথা	Br̥thā
ব্যস্তবাগীশ	Byastabāgīśa
হৈচৈ	Haicai
লয়	Laẏa
বিমানপোতের কাঠাম	Bimānapōtēra kāṭhāma
ফিউজ বক্স	Phi'uja baksa
ফিউজ্	Phi'uj
উন্মত্ততা	Unmattatā
অলক্ষ্যে	Alakṣyē
অলক্ষিত	Alakṣita
সর্বাধিক দূরে	Sarbādhika dūrē
তদ্ব্যতীত	Tadbyatīta
অধিকতর	Adhikatara
লোমযুক্ত	Lōmayukta
খাঁজ কাটা	Khām̐ja kāṭā
উন্মাদনা	Unmādanā
আসবাবপত্র	Āsabābapatra
গৃহসজ্জা	Gr̥hasajjā
সজ্জিত	Sajjita
সজ্জিত করা	Sajjita karā
অগ্নিকুণ্ড	Agnikuṇḍa
Furlong	Furlong
দুমড়ান	Dumaṛāna
উন্মত্তবৎ	Unmattabaṯ
অগ্নিশর্মা	Agniśarmā
পশম	Paśama
মজার হাড়	Majāra hāṛa
মজার	Majāra
অদ্ভুতভাবে	Adbhutabhābē
Funnies	Funnies
ফানেলের মেঘ	Phānēlēra mēgha
ফানেল	Phānēla
ভয়াতুর	Bhaẏātura
কাপুরূষ	Kāpurūṣa
ছাতা	Chātā
ছত্রাক	Chatrāka
ফাংগাল	Phāṅgāla
শেষকৃত্যের হোম	Śēṣakr̥tyēra hōma
অন্ত্যেষ্টিক্রিয়া পরিচালক	Antyēṣṭikriẏā paricālaka
অন্ত্যেষ্টিক্রিয়া	Antyēṣṭikriẏā
তহবিল	Tahabila
তহবিল বৃদ্ধিকারী	Tahabila br̥d'dhikārī
তহবিল	Tahabila
মৌলিক	Maulika
মৌলিকভাবে	Maulikabhābē
অন্ধবিশ্বাসী	Andhabiśbāsī
অন্ধবিশ্বাস	Andhabiśbāsa
মৌলিক	Maulika
তহবিল	Tahabila
বৈশিষ্ট্যগুলি	Baiśiṣṭyaguli
কার্মিক	Kārmika
ক্রিয়া	Kriẏā
মজা	Majā
উপধূপন	Upadhūpana
বাষ্প দেত্তয়া	Bāṣpa dēttaẏā
ধোঁয়া	Dhōm̐ẏā
ধূম্র	Dhūmra
এলোমেলো কথা বলা	Ēlōmēlō kathā balā
সম্পূর্ণরূপে	Sampūrṇarūpē
পুরো সময়	Purō samaẏa
পূর্ণ মাত্রার	Pūrṇa mātrāra
পূর্ণিমা	Pūrṇimā
পূর্ণপ্রসারিত দেহে	Pūrṇaprasārita dēhē
পুরো ঘর	Purō ghara
কারকিত	Kārakita
প্রফুল্লিত	Praphullita
পূর্ণ	Pūrṇa
সিদ্ধি	Sid'dhi
পরিপূরক	Paripūraka
পূর্ণ	Pūrṇa
মেটান	Mēṭāna
অবলম্বন	Abalambana
পলাতক	Palātaka
জ্বালানি	Jbālāni
অর্থহীন	Arthahīna
যৌনসঙ্গম	Yaunasaṅgama
fucker	Fucker
আপ fucked	Āpa fucked
যৌনসঙ্গম	Yaunasaṅgama
ফুট .	Phuṭa.
ফ্রাইং প্যান	Phrā'iṁ pyāna
চড়ুইভাতি	Caṛu'ibhāti
পরাজয়	Parājaẏa
হতাশাজনক	Hatāśājanaka
হতাশ	Hatāśa
পরাভূত করা	Parābhūta karā
frumpy	Frumpy
ফলবতী	Phalabatī
ফল	Phala
fruitlessly	Fruitlessly
নিষ্ফল	Niṣphala
সিদ্ধি	Sid'dhi
ফলপ্রসূ	Phalaprasū
ফলের মাছি	Phalēra māchi
fruitcake	Fruitcake
ফল	Phala
frugally	Frugally
মিতব্যয়	Mitabyaẏa
মিতব্যয়ী	Mitabyaẏī
হিমায়িত	Himāẏita
নিথর হয়েছে	Nithara haẏēchē
ভ্রূকুটি	Bhrūkuṭi
শূন্যগর্ভ	Śūn'yagarbha
ফেনা	Phēnā
তুষারতুল্য	Tuṣāratulya
তুষারকণা	Tuṣārakaṇā
তুষারপাত	Tuṣārapāta
তুষারাবৃত	Tuṣārābr̥ta
তুষারস্পর্শে দেহের প্রদাহ	Tuṣārasparśē dēhēra pradāha
হিম	Hima
সামনে মানুষ	Sāmanē mānuṣa
সীমানা	Sīmānā
সীমান্ত	Sīmānta
সম্মুখ	Sam'mukha
সম্মূখভাগ	Sam'mūkhabhāga
সদর	Sadara
পর্ণ	Parṇa
থেকে	Thēkē
কৌতুক	Kautuka
বেঙ	Bēṅa
ইতস্তত	Itastata
frizzy	Frizzy
কোঁকড়ান	Kōm̐kaṛāna
frivolously	Frivolously
অসার	Asāra
মূর্খতা	Mūrkhatā
শামুক	Śāmuka
ক্রীড়ারত	Krīṛārata
উল্লম্ফন	Ullamphana
Frisbee	Frisbee
পাড় সুবিধা	Pāṛa subidhā
পাড়	Pāṛa
আড়ম্বরপূর্ণ	Āṛambarapūrṇa
ঝালর	Jhālara
নিরাবেগ	Nirābēga
হিমশীতল	Himaśītala
ভয়ঙ্কর	Bhaẏaṅkara
frighteningly	Frighteningly
ভয়ানক	Bhaẏānaka
ভীত	Bhīta
আতঙ্কিত	Ātaṅkita
ভয়	Bhaẏa
রণতরিবিশেষ	Raṇataribiśēṣa
ছাদের কারুকার্য	Chādēra kārukārya
ফ্রাই	Phrā'i
বন্ধুত্ব	Bandhutba
বন্ধুত্বপূর্ণ	Bandhutbapūrṇa
বন্ধুভাবাপন্নতা	Bandhubhābāpannatā
বন্ধুহীন	Bandhuhīna
বন্ধু	Bandhu
ভাজা	Bhājā
রেফ্রিজারেটর	Rēphrijārēṭara
শুক্রবার	Śukrabāra
ঘর্ষণ	Gharṣaṇa
খ্রীষ্টান ভিক্ষু	Khrīṣṭāna bhikṣu
শুক্র	Śukra
ফ্রয়েডের	Phraẏēḍēra
বদমেজাজি	Badamējāji
জ্বালাতন করা	Jbālātana karā
ঈষৎ	Īṣaṯ
ঠাণ্ডাই	Ṭhāṇḍā'i
নবীন	Nabīna
পুনশ্চ	Punaśca
তাজা করা	Tājā karā
তাজা	Tājā
ঘনঘন	Ghanaghana
ঘন	Ghana
ফ্রিকোয়েন্সি	Phrikōẏēnsi
উন্মত্ততা	Unmattatā
প্রমত্ত	Pramatta
ফ্যানাটিক	Phyānāṭika
ফরাসি টোস্ট	Pharāsi ṭōsṭa
ফরাসি ভাজা	Pharāsi bhājā
ফরাসি রুটি	Pharāsi ruṭi
ফরাসি	Pharāsi
মালবাহী ট্রেন	Mālabāhī ṭrēna
ফ্রেইটারের	Phrē'iṭārēra
মালবাহী	Mālabāhī
হিমাঙ্ক	Himāṅka
জমা	Jamā
হিমায়ক	Himāẏaka
- নিথর শুকনো	- Nithara śukanō
হিমায়িত করা	Himāẏita karā
স্বাধীন ইচ্ছা	Sbādhīna icchā
freewheeling	Freewheeling
ফ্রিওয়ে	Phri'ōẏē
Freethinking	Freethinking
যুক্তিবাদী	Yuktibādī
বাক স্বাধীনতা	Bāka sbādhīnatā
বিনামূল্যে - পরিসীমা	Bināmūlyē - parisīmā
মুক্ত বাজার	Mukta bājāra
অবাধে	Abādhē
freeloader	Freeloader
freeload	Freeload
ফ্রিল্যান্সার	Phrilyānsāra
ফ্রিল্যান্স	Phrilyānsa
খালিহাতে কৃত	Khālihātē kr̥ta
বিনামূল্যে জন্য সব	Bināmūlyē jan'ya saba
ফ্রি এন্টারপ্রাইজ	Phri ēnṭāraprā'ija
স্বাধীনতা	Sbādhīnatā
freebie	Freebie
বিনামূল্যে	Bināmūlyē
freckled	Freckled
ছুলি	Chuli
খেয়াল আউট	Khēẏāla ā'uṭa
খামখেয়াল	Khāmakhēẏāla
দাঙ্গাহাঙ্গামা	Dāṅgāhāṅgāmā
পরিপূর্ণ	Paripūrṇa
জালিয়াতির মাধ্যমে	Jāliẏātira mādhyamē
প্রতারণাপূর্ণ	Pratāraṇāpūrṇa
প্রতারণা	Pratāraṇā
ভাই-ভাই হত্তয়া	Bhā'i-bhā'i hattaẏā
সমধর্মিতা	Samadharmitā
ভ্রাতৃসংক্রান্ত	Bhrātr̥saṅkrānta
Frat	Frat
উন্মত্তবৎ	Unmattabaṯ
ক্ষিপ্ত	Kṣipta
সরলতা	Saralatā
উন্মুক্তভাবে	Unmuktabhābē
Frankfurter	Frankfurter
দিলদরিয়া	Diladariẏā
ভোটাধিকার	Bhōṭādhikāra
ফ্রাংক	Phrāṅka
কাঠামো	Kāṭhāmō
ফ্রেম	Phrēma
ভঙ্গুরতা	Bhaṅguratā
অথর্ব	Atharba
সুগন্ধি	Sugandhi
সুবাস	Subāsa
টুকরা	Ṭukarā
ভঙ্গুরতা	Bhaṅguratā
ভঙ্গুর	Bhaṅgura
ফাটল	Phāṭala
ঝগড়াটে	Jhagaṛāṭē
fractionally	Fractionally
ভগ্নাঙ্কঘটিত	Bhagnāṅkaghaṭita
ভগ্নাংশ	Bhagnānśa
হট্টগোল	Haṭṭagōla
হোটেলের বড় হলঘর	Hōṭēlēra baṛa halaghara
চতুর	Catura
Foxtrot	Foxtrot
আশ্রয়-কোটর	Āśraẏa-kōṭara
শিয়াল	Śiẏāla
পাখি	Pākhi
চার চাকা ড্রাইভ	Cāra cākā ḍrā'ibha
জুলাই চতুর্থ	Julā'i caturtha
চতুর্থত	Caturthata
চতুর্থ	Caturtha
চতুর্দশ	Caturdaśa
চতুর্দশ	Caturdaśa
মুখখিস্তি	Mukhakhisti
চার পাতার ক্লোভার	Cāra pātāra klōbhāra
চার	Cāra
পেন	Pēna
ফোয়ারা	Phōẏārā
ঢালাইয়ের কারখানা	Ḍhālā'iẏēra kārakhānā
জনক	Janaka
প্রতিষ্ঠাতা	Pratiṣṭhātā
ভিত	Bhita
পাওয়া	Pā'ōẏā
জুয়াচুরি	Juẏācuri
ফাউল বল	Phā'ula bala
নোংরা	Nōnrā
প্রতিদ্বন্দিতাপূর্ণ	Pratidbanditāpūrṇa
লালনপালন করা	Lālanapālana karā
অশ্মীভূত করা	Aśmībhūta karā
জীবাশ্ম জ্বালানী	Jībāśma jbālānī
জীবাশ্ম	Jībāśma
forwent	Forwent
সম্মুখে	Sam'mukhē
দূরদর্শী	Dūradarśī
অগ্রবর্তী ঠিকানা	Agrabartī ṭhikānā
অগ্রবর্তী	Agrabartī
ফোরাম	Phōrāma
চল্লিশ	Calliśa
ভাগ্যপরীক্ষক	Bhāgyaparīkṣaka
ভাগ্য কুকি	Bhāgya kuki
ভাগ্য	Bhāgya
ভাগ্যক্রমে	Bhāgyakramē
ঋদ্ধ	R̥d'dha
আধিদৈবিক	Ādhidaibika
দুর্গ	Durga
সহ্য	Sahya
শক্তি বাড়ান	Śakti bāṛāna
দুর্গ	Durga
চত্বারিংশত্তম	Catbārinśattama
স্পষ্টাস্পষ্টি	Spaṣṭāspaṣṭi
আসন্ন	Āsanna
উচ্চৈ: স্বরে	Uccai: Sbarē
উদাত্ত সুর	Udātta sura
কেল্লা	Kēllā
forsworn	Forsworn
forswore	Forswore
মিথ্যা শপথ করা	Mithyā śapatha karā
ত্যাগ	Tyāga
পরিত্যক্ত	Parityakta
পরিত্যাগ করা	Parityāga karā
ব্যভিচার	Byabhicāra
ব্যভিচার	Byabhicāra
তৈয়ার	Taiẏāra
সূত্রবদ্ধ করা	Sūtrabad'dha karā
সূত্র	Sūtra
সূত্র	Sūtra
ফর্ম চিঠি	Pharma ciṭhi
নিরাকার	Nirākāra
formidably	Formidably
দুর্দান্ত	Durdānta
পূর্বে	Pūrbē
সাবেক	Sābēka
গঠনমূলক	Gaṭhanamūlaka
গঠন	Gaṭhana
বিন্যাস	Bin'yāsa
যথাবিধি	Yathābidhi
ডিক্রী করা	Ḍikrī karā
আনুষ্ঠানিকতা	Ānuṣṭhānikatā
ফর্মালডিহাইড	Pharmālaḍ'̔ihā'iḍa
আনুষ্ঠানিক	Ānuṣṭhānika
ফর্ম	Pharma
অভাগা	Abhāgā
ফর্ক লিফট	Pharka liphaṭa
কাঁটাত্তয়ালা	Kām̐ṭāttaẏālā
বিস্মৃত	Bismr̥ta
কাঁটাচামচ	Kām̐ṭācāmaca
ভুলে গেছি	Bhulē gēchi
forgone	Forgone
ত্যাগ করা	Tyāga karā
মার্জনা	Mārjanā
ক্ষমা	Kṣamā
ক্ষমা	Kṣamā
ক্ষমা করা	Kṣamā karā
মার্জনীয়	Mārjanīẏa
ফরগের্টমিনট	Pharagērṭaminaṭa
বিস্মৃতি	Bismr̥ti
ভুলো	Bhulō
ভুলে	Bhulē
জালিয়াতি	Jāliẏāti
কামার	Kāmāra
কামারশালা	Kāmāraśālā
forgave	Forgave
বাজেয়াপ্ত	Bājēẏāpta
ভূমিকা	Bhūmikā
পূর্বেই সতর্ক করা	Pūrbē'i satarka karā
চিরতরে	Ciratarē
ভবিষ্যদ্বাণী করেছিলেন	Bhabiṣyadbāṇī karēchilēna
দূরদর্শিতা	Dūradarśitā
গনা	Ganā
পূর্বাস্বাদন	Pūrbāsbādana
বনপালনবিদ্যা	Banapālanabidyā
কিছু আগে করা	Kichu āgē karā
বন	Bana
লিঙ্গত্বক্	Liṅgatbak
দূরদর্শিতা	Dūradarśitā
পূর্বাভাস দেত্তয়া	Pūrbābhāsa dēttaẏā
foreseen	Foreseen
সুদুর	Sudura
আগেই জানা	Āgē'i jānā
ভাবিষ্যদ্বাণী	Bhābiṣyadbāṇī
অগ্রদূত	Agradūta
foreplay	Foreplay
আদালতসম্বন্ধীয়	Ādālatasambandhīẏa
প্রধানতম	Pradhānatama
মোড়ল	Mōṛala
বৈদেশিক মুদ্রা	Baidēśika mudrā
বিদেশী	Bidēśī
বিদেশী	Bidēśī
কপাল	Kapāla
মিতব্যয়ী	Mitabyaẏī
পুরোভূমি	Purōbhūmi
একেবারে পুরোভাগ	Ēkēbārē purōbhāga
তর্জনী	Tarjanī
ফোরক্লোসারের	Phōraklōsārēra
নিবারণ করা	Nibāraṇa karā
পূর্বাভাস	Pūrbābhāsa
পূর্বলক্ষণ	Pūrbalakṣaṇa
হস্ত	Hasta
সম্মুখ	Sam'mukha
হাঁটুজল	Hām̐ṭujala
বলপূর্বক	Balapūrbaka
জবরদস্ত	Jabaradasta
সাঁড়াশী	Sām̐ṛāśī
সজোরে	Sajōrē
জবরদস্ত	Jabaradasta
বল প্রতিপালিত	Bala pratipālita
জোর করিয়া খাত্তয়ান	Jōra kariẏā khāttaẏāna
বাধ্য	Bādhya
বল	Bala
forborne	Forborne
forbore	Forbore
মানা	Mānā
নিষিদ্ধ	Niṣid'dha
নিষেধ করা	Niṣēdha karā
নিবৃত্তি	Nibr̥tti
পূর্বপুরুষ	Pūrbapuruṣa
forbade	Forbade
হানা	Hānā
ঘাস	Ghāsa
জন্য	Jan'ya
পা-চালনার কৌশল	Pā-cālanāra kauśala
পাদুকা	Pādukā
পদচিহ্ন	Padacihna
পাদ	Pāda
পদাঙ্ক	Padāṅka
ফুটপাথ	Phuṭapātha
পাদটীকা	Pādaṭīkā
মুক্ত	Mukta
Footlocker	Footlocker
পাদপ্রদীপ	Pādapradīpa
পদবিক্ষেপ	Padabikṣēpa
পা রাখার জায়গা	Pā rākhāra jāẏagā
Foothill	Foothill
পদব্রজে গমনকারীদের জন্য সেতু	Padabrajē gamanakārīdēra jan'ya sētu
ফুটবল	Phuṭabala
ফুটেজ	Phuṭēja
পা	Pā
অব্যর্থ	Abyartha
অনভিজ্ঞতা	Anabhijñatā
মূর্খতাপূর্ণভাবে	Mūrkhatāpūrṇabhābē
গবা	Gabā
হঠকারী	Haṭhakārī
মূর্খ	Mūrkha
আহার্য সামগ্রী	Āhārya sāmagrī
খাদ্য স্ট্যাম্প	Khādya sṭyāmpa
খাদ্য প্রসেসর	Khādya prasēsara
খাদ্যে বিষক্রিয়া	Khādyē biṣakriẏā
খাদ্য	Khādya
ফন্ট	Phanṭa
স্নেহ	Snēha
কোমলভাবে	Kōmalabhābē
আদর করা	Ādara karā
অনুরাগী	Anurāgī
প্ররোচিত করা	Prarōcita karā
মূর্খতা	Mūrkhatā
অনুপ্রেরিত	Anuprērita
অনুসরণ	Anusaraṇa
শিষ্য	Śiṣya
অনুসরণ করা	Anusaraṇa karā
গুটিকা	Guṭikā
গণতান্ত্রিক	Gaṇatāntrika
ভাবেন	Bhābēna
লোক সঙ্গীত	Lōka saṅgīta
লোকাচারবিদ্যা	Lōkācārabidyā
লোক	Lōka
পর্ণরাজি	Parṇarāji
ফোল্ডার	Phōlḍāra
ভাঁজ	Bhām̐ja
গ্রহণ করান	Grahaṇa karāna
তবক	Tabaka
দুর্বলতা	Durbalatā
পুরান ধারণার	Purāna dhāraṇāra
সাইরেন	Sā'irēna
কুয়াশাচ্ছন্ন	Kuẏāśācchanna
fogbound	Fogbound
কুয়াশা	Kuẏāśā
শত্রু	Śatru
গবাদি পশুর জাব	Gabādi paśura jāba
ফোকাস	Phōkāsa
foci	Foci
ফোকাল পয়েন্ট	Phōkāla paẏēnṭa
ফেনিল	Phēnila
ফেনা রাবার	Phēnā rābāra
ফেনা	Phēnā
গর্দভশাবক	Gardabhaśābaka
এফএম	Ēpha'ēma
Flyswatter	Flyswatter
উড়ন্ত ডিশ্	Uṛanta ḍiś
উড়ন্ত	Uṛanta
বিমানপোতের নৈশধাবন	Bimānapōtēra naiśadhābana
বল উড়ে	Bala uṛē
মাছি	Māchi
গলান	Galāna
ঝাপটানি	Jhāpaṭāni
বংশীবাদক	Banśībādaka
বাঁশি	Bām̐śi
flustered	Flustered
হৈচৈ	Haicai
রাঙা	Rāṅā
ঘনিষ্ঠরূপে	Ghaniṣṭharūpē
বিক্ষোভ	Bikṣōbha
ফ্লোরাইড	Phlōrā'iḍa
প্রতিপ্রভ	Pratiprabha
চাপরাসি	Cāparāsi
কার্যবিপত্তি	Kāryabipatti
প্রক্ষিপ্ত	Prakṣipta
অপ্রত্যাশিত সাফল্য	Apratyāśita sāphalya
তরল	Tarala
তরল আউন্স	Tarala ā'unsa
তারল্য	Tāralya
তরল	Tarala
ফুঁয়োফুঁয়ো	Phum̐ẏōphum̐ẏō
নরম লোম	Narama lōma
অনর্গল	Anargala
অনর্গল	Anargala
বাক্পটুতা	Bākpaṭutā
চিমনী	Cimanī
অস্থিরতা	Asthiratā
অস্থির হত্তয়া	Asthira hattaẏā
তালগোল	Tālagōla
ফ্লু	Phlu
